(supertux-level
  (version 2)
  (name (_ "Bonus level 2 - Badguys' revenge"))
  (author "hume")         (license "GPL 2+ / CC-by-sa 3.0")
  (sector
    (name "main")
    (music "music/invincible.ogg")
    (init-script "import(\"levels/hume/defualt.nut\")
unlock_archivement(\"m\")
unlock_archivement(\"n\")
")
    (ambient-light 1 1 1)
    (background
      (speed 0.5)
      (image-top "images/background/BlueRock_Forest/blue-top.jpg")
      (image "images/background/BlueRock_Forest/blue-middle.jpg")
      (image-bottom "images/background/BlueRock_Forest/blue-bottom.jpg")
    )
    (camera
      (mode "normal")
    )
    (dispenser
      (badguy "bouncingsnowball")
      (cycle 2)
      (x 224)
      (y 32)
    )
    (dispenser
      (badguy "snowball")
      (cycle 1)
      (x 96)
      (y 32)
    )
    (dispenser
      (badguy "random")
      (cycle 128)
      (x 992)
      (y 32)
    )
    (dispenser
      (badguy "mrbomb")
      (cycle 4)
      (x 352)
      (y 32)
    )
    (dispenser
      (badguy "mriceblock")
      (cycle 8)
      (x 480)
      (y 32)
    )
    (dispenser
      (badguy "snail")
      (cycle 16)
      (x 608)
      (y 32)
    )
    (dispenser
      (badguy "poisonivy")
      (cycle 32)
      (x 736)
      (y 32)
    )
    (dispenser
      (badguy "skullyhop")
      (cycle 64)
      (x 864)
      (y 32)
    )
    (firefly
      (x 480)
      (y 608)
      (sprite "images/objects/resetpoints/bell.sprite")
    )
    (scripttrigger
      (script "if (!(\"therewas\" in  this)){
bonus <- {seconds=0}
therewas <- true
while (bonus.seconds<60){
wait(1);
bonus.seconds <- bonus.seconds+1
sector.Tux.add_coins(1);
}
unlock_archivement(\"r\")
while (true){
wait(1);
sector.Tux.add_coins(2);
}
}")
      (button #f)
      (width 488)
      (height 32)
      (x 256)
      (y 640)
    )
    (spawnpoint
      (name "main")
      (x 480)
      (y 576)
    )
    (switch
      (script "sector.Tux.trigger_sequence(\"fireworks\")")
      (x 32)
      (y 672)
      (sprite "images/objects/switch/right.sprite")
    )
    (tilemap
      (z-pos -100)
      (solid #f)
      (name "Background")
      (width 35)
      (height 25)
      (tiles
      2647 2648 2649 2650 2647 2648 2649 2650 2647 2648 2649 2650 2647 2648 2649 2650 2647 2648 2649 2650 2647 2648 2649 2650 2647 2648 2649 2650 2647 2648 2649 2650 2647 2648 2649
      2651 2652 2653 2654 2651 2652 2653 2654 2651 2652 2653 2654 2651 2652 2653 2654 2651 2652 2653 2654 2651 2652 2653 2654 2651 2652 2653 2654 2651 2652 2653 2654 2651 2652 2653
      2647 2648 2649 2650 2647 2648 2649 2650 2647 2648 2649 2650 2647 2648 2649 2650 2647 2648 2649 2650 2647 2648 2649 2650 2647 2648 2649 2650 2647 2648 2649 2650 2647 2648 2649
      2651 2652 2653 2654 2651 2652 2653 2654 2651 2652 2653 2654 2651 2652 2653 2654 2651 2652 2653 2654 2651 2652 2653 2654 2651 2652 2653 2654 2651 2652 2653 2654 2651 2652 2653
      2647 2648 2649 2650 2647 2648 2649 2650 2647 2648 2649 2650 2647 2648 2649 2650 2647 2648 2649 2650 2647 2648 2649 2650 2647 2648 2649 2650 2647 2648 2649 2650 2647 2648 2649
      2651 2652 2653 2654 2651 2652 2653 2654 2651 2652 2653 2654 2651 2652 2653 2654 2651 2652 2653 2654 2651 2652 2653 2654 2651 2652 2653 2654 2651 2652 2653 2654 2651 2652 2653
      2647 2648 2649 2650 2647 2648 2649 2650 2647 2648 2649 2650 2647 2648 2649 2650 2647 2648 2649 2650 2647 2648 2649 2650 2647 2648 2649 2650 2647 2648 2649 2650 2647 2648 2649
      2651 2652 2653 2654 2651 2652 2653 2654 2651 2652 2653 2654 2651 2652 2653 2654 2651 2652 2653 2654 2651 2652 2653 2654 2651 2652 2653 2654 2651 2652 2653 2654 2651 2652 2653
      2647 2648 2649 2650 2647 2648 2649 2650 2647 2648 2649 2650 2647 2648 2649 2650 2647 2648 2649 2650 2647 2648 2649 2650 2647 2648 2649 2650 2647 2648 2649 2650 2647 2648 2649
      2651 2652 2653 2654 2651 2652 2653 2654 2651 2652 2653 2654 2651 2652 2653 2654 2651 2652 2653 2654 2651 2652 2653 2654 2651 2652 2653 2654 2651 2652 2653 2654 2651 2652 2653
      2647 2648 2649 2650 2647 2648 2649 2650 2647 2648 2649 2650 2647 2648 2649 2650 2647 2648 2649 2650 2647 2648 2649 2650 2647 2648 2649 2650 2647 2648 2649 2650 2647 2648 2649
      2651 2652 2653 2654 2651 2652 2653 2654 2651 2652 2653 2654 2651 2652 2653 2654 2651 2652 2653 2654 2651 2652 2653 2654 2651 2652 2653 2654 2651 2652 2653 2654 2651 2652 2653
      2647 2648 2649 2650 2647 2648 2649 2650 2647 2648 2649 2650 2647 2648 2649 2650 2647 2648 2649 2650 2647 2648 2649 2650 2647 2648 2649 2650 2647 2648 2649 2650 2647 2648 2649
      2651 2652 2653 2654 2651 2652 2653 2654 2651 2652 2653 2654 2651 2652 2653 2654 2651 2652 2653 2654 2651 2652 2653 2654 2651 2652 2653 2654 2651 2652 2653 2654 2651 2652 2653
      2647 2648 2649 2650 2647 2648 2649 2650 2647 2648 2649 2650 2647 2648 2649 2650 2647 2648 2649 2650 2647 2648 2649 2650 2647 2648 2649 2650 2647 2648 2649 2650 2647 2648 2649
      2651 2652 2653 2654 2651 2652 2653 2654 2651 2652 2653 2654 2651 2652 2653 2654 2651 2652 2653 2654 2651 2652 2653 2654 2651 2652 2653 2654 2651 2652 2653 2654 2651 2652 2653
      2647 2648 2649 2650 2647 2648 2649 2650 2647 2648 2649 2650 2647 2648 2649 2650 2647 2648 2649 2650 2647 2648 2649 2650 2647 2648 2649 2650 2647 2648 2649 2650 2647 2648 2649
      2651 2652 2653 2654 2651 2652 2653 2654 2651 2652 2653 2654 2651 2652 2653 2654 2651 2652 2653 2654 2651 2652 2653 2654 2651 2652 2653 2654 2651 2652 2653 2654 2651 2652 2653
      2647 2648 2649 2650 2647 2648 2649 2650 2647 2648 2649 2650 2647 2648 2649 2650 2647 2648 2649 2650 2647 2648 2649 2650 2647 2648 2649 2650 2647 2648 2649 2650 2647 2648 2649
      2651 2652 2653 2654 2651 2652 2653 2654 2651 2652 2653 2654 2651 2652 2653 2654 2651 2652 2653 2654 2651 2652 2653 2654 2651 2652 2653 2654 2651 2652 2653 2654 2651 2652 2653
      2647 2648 2649 2650 2647 2648 2649 2650 2647 2648 2649 2650 2647 2648 2649 2650 2647 2648 2649 2650 2647 2648 2649 2650 2647 2648 2649 2650 2647 2648 2649 2650 2647 2648 2649
      2651 2652 2653 2654 2651 2652 2653 2654 2651 2652 2653 2654 2651 2652 2653 2654 2651 2652 2653 2654 2651 2652 2653 2654 2651 2652 2653 2654 2651 2652 2653 2654 2651 2652 2653
      2647 2648 2649 2650 2647 2648 2649 2650 2647 2648 2649 2650 2647 2648 2649 2650 2647 2648 2649 2650 2647 2648 2649 2650 2647 2648 2649 2650 2647 2648 2649 2650 2647 2648 2649
      2651 2652 2653 2654 2651 2652 2653 2654 2651 2652 2653 2654 2651 2652 2653 2654 2651 2652 2653 2654 2651 2652 2653 2654 2651 2652 2653 2654 2651 2652 2653 2654 2651 2652 2653
      2647 2648 2649 2650 2647 2648 2649 2650 2647 2648 2649 2650 2647 2648 2649 2650 2647 2648 2649 2650 2647 2648 2649 2650 2647 2648 2649 2650 2647 2648 2649 2650 2647 2648 2649
      )
    )
    (tilemap
      (z-pos 0)
      (solid #t)
      (name "Interactive")
      (width 35)
      (height 25)
      (tiles
      2472 2507 2508 2507 2508 2507 2508 2507 2508 2507 2508 2507 2508 2507 2508 2507 2508 2507 2508 2507 2508 2507 2508 2507 2508 2507 2508 2507 2508 2507 2508 2507 2508 2507 2469
      2468 0 0 0 0 0 0 0 0 0 0 0 0 0 0 0 0 0 0 0 0 0 0 0 0 0 0 0 0 0 0 0 0 0 2463
      2482 0 0 0 0 0 0 0 0 0 0 0 0 0 0 0 0 0 0 0 0 0 0 0 0 0 0 0 0 0 0 0 0 0 2477
      2496 0 0 0 0 0 0 0 0 0 0 0 0 0 0 0 0 0 0 0 0 0 0 0 0 0 0 0 0 0 0 0 0 0 2491
      2468 0 0 0 0 0 0 0 0 0 0 0 0 0 0 0 0 0 0 0 0 0 0 0 0 0 0 0 0 0 0 0 0 0 2463
      2482 0 0 0 0 0 0 0 0 0 0 0 0 0 0 0 0 0 0 0 0 0 0 0 0 0 0 0 0 0 0 0 0 0 2477
      2496 0 0 0 0 0 0 0 0 0 0 0 0 0 0 0 0 0 0 0 0 0 0 0 0 0 0 0 0 0 0 0 0 0 2491
      2468 0 0 0 0 0 0 0 0 0 0 0 0 0 0 0 0 0 0 0 0 0 0 0 0 0 0 0 0 0 0 0 0 0 2463
      2482 0 0 0 0 0 0 0 0 0 0 0 0 0 0 0 0 0 0 0 0 0 0 0 0 0 0 0 0 0 0 0 0 0 2477
      2496 0 0 0 0 0 0 0 0 0 0 0 0 0 0 0 0 0 0 0 0 0 0 0 0 0 0 0 0 0 0 0 0 0 2491
      2468 0 0 0 0 0 0 0 0 0 0 0 0 0 0 0 0 0 0 0 0 0 0 0 0 0 0 0 0 0 0 0 0 0 2463
      2482 0 0 0 0 0 0 0 0 0 0 0 0 0 0 0 0 0 0 0 0 0 0 0 0 0 0 0 0 0 0 0 0 0 2477
      2496 0 0 0 0 0 0 0 0 0 0 0 0 0 0 0 0 0 0 0 0 0 0 0 0 0 0 0 0 0 0 0 0 0 2491
      2468 0 0 0 0 0 0 0 0 0 0 0 0 0 0 0 0 0 0 0 0 0 0 0 0 0 0 0 0 0 0 0 0 0 2463
      2482 0 0 0 0 0 0 0 0 0 0 0 0 0 0 0 0 0 0 0 0 0 0 0 0 0 0 0 0 0 0 0 0 0 2477
      2496 0 0 0 0 0 0 0 0 0 0 0 0 0 0 0 0 0 0 0 0 0 0 0 0 0 0 0 0 0 0 0 0 0 2491
      2468 0 0 0 0 0 0 0 0 0 0 0 0 0 0 0 0 0 0 0 0 0 0 0 0 0 0 0 0 0 0 0 0 0 2463
      2482 0 0 0 0 0 0 0 0 0 0 0 0 0 0 0 0 0 0 0 0 0 0 0 0 0 0 0 0 0 0 0 0 0 2477
      2496 0 0 0 0 0 0 0 0 0 0 0 0 0 0 0 0 0 0 0 0 0 0 0 0 0 0 0 0 0 0 0 0 0 2491
      2468 0 0 0 0 0 0 0 0 0 0 0 0 0 0 0 0 0 0 0 0 0 0 0 0 0 0 0 0 0 0 0 0 0 2463
      2482 0 0 0 0 0 0 0 0 0 0 0 0 0 0 0 0 0 0 0 0 0 0 0 0 0 0 0 0 0 0 0 0 0 2463
      2496 0 0 0 0 0 0 0 0 0 0 0 0 0 0 0 0 0 0 0 0 0 0 0 0 0 0 0 0 0 0 0 0 0 2477
      2416 0 0 0 0 0 0 0 0 0 0 0 0 0 0 0 0 0 0 0 0 0 0 0 0 0 0 0 0 0 0 0 0 0 2491
      2430 2423 2424 2423 2424 2423 2424 2423 2424 2423 2424 2423 2424 2423 2424 2423 2424 2423 2424 2423 2424 2423 2424 2423 2424 2423 2424 2423 2424 2423 2424 2423 2424 2423 2413
      2444 2437 2438 2437 2438 2437 2438 2437 2438 2437 2438 2437 2438 2437 2438 2437 2438 2437 2438 2437 2438 2437 2438 2437 2438 2437 2438 2437 2438 2437 2438 2437 2438 2437 2427
      )
    )
    (tilemap
      (z-pos 100)
      (solid #f)
      (name "Foreground")
      (width 35)
      (height 25)
      (tiles
      0 0 0 0 0 0 0 0 0 0 0 0 0 0 0 0 0 0 0 0 0 0 0 0 0 0 0 0 0 0 0 0 0 0 0
      0 0 0 0 0 0 0 0 0 0 0 0 0 0 0 0 0 0 0 0 0 0 0 0 0 0 0 0 0 0 0 0 0 0 0
      0 0 0 0 0 0 0 0 0 0 0 0 0 0 0 0 0 0 0 0 0 0 0 0 0 0 0 0 0 0 0 0 0 0 0
      0 0 0 0 0 0 0 0 0 0 0 0 0 0 0 0 0 0 0 0 0 0 0 0 0 0 0 0 0 0 0 0 0 0 0
      0 0 0 0 0 0 0 0 0 0 0 0 0 0 0 0 0 0 0 0 0 0 0 0 0 0 0 0 0 0 0 0 0 0 0
      0 0 0 0 0 0 0 0 0 0 0 0 0 0 0 0 0 0 0 0 0 0 0 0 0 0 0 0 0 0 0 0 0 0 0
      0 0 0 0 0 0 0 0 0 0 0 0 0 0 0 0 0 0 0 0 0 0 0 0 0 0 0 0 0 0 0 0 0 0 0
      0 0 0 0 0 0 0 0 0 0 0 0 0 0 0 0 0 0 0 0 0 0 0 0 0 0 0 0 0 0 0 0 0 0 0
      0 0 0 0 0 0 0 0 0 0 0 0 0 0 0 0 0 0 0 0 0 0 0 0 0 0 0 0 0 0 0 0 0 0 0
      0 0 0 0 0 0 0 0 0 0 0 0 0 0 0 0 0 0 0 0 0 0 0 0 0 0 0 0 0 0 0 0 0 0 0
      0 0 0 0 0 0 0 0 0 0 0 0 0 0 0 0 0 0 0 0 0 0 0 0 0 0 0 0 0 0 0 0 0 0 0
      0 0 0 0 0 0 0 0 0 0 0 0 0 0 0 0 0 0 0 0 0 0 0 0 0 0 0 0 0 0 0 0 0 0 0
      0 0 0 0 0 0 0 0 0 0 0 0 0 0 0 0 0 0 0 0 0 0 0 0 0 0 0 0 0 0 0 0 0 0 0
      0 0 0 0 0 0 0 0 0 0 0 0 0 0 0 0 0 0 0 0 0 0 0 0 0 0 0 0 0 0 0 0 0 0 0
      0 0 0 0 0 0 0 0 0 0 0 0 0 0 0 0 0 0 0 0 0 0 0 0 0 0 0 0 0 0 0 0 0 0 0
      0 0 0 0 0 0 0 0 0 0 0 0 0 0 0 0 0 0 0 0 0 0 0 0 0 0 0 0 0 0 0 0 0 0 0
      0 0 0 0 0 0 0 0 0 0 0 0 0 0 0 0 0 0 0 0 0 0 0 0 0 0 0 0 0 0 0 0 0 0 0
      0 0 0 0 0 0 0 0 0 0 0 0 0 0 0 0 0 0 0 0 0 0 0 0 0 0 0 0 0 0 0 0 0 0 0
      0 0 0 0 0 0 0 0 0 0 0 0 0 0 0 0 0 0 0 0 0 0 0 0 0 0 0 0 0 0 0 0 0 0 0
      0 0 0 0 0 0 0 0 0 0 0 0 0 0 0 0 0 0 0 0 0 0 0 0 0 0 0 0 0 0 0 0 0 0 0
      0 0 0 0 0 0 0 0 0 0 0 0 0 0 0 0 0 0 0 0 0 0 0 0 0 0 0 0 0 0 0 0 0 0 0
      0 0 0 0 0 0 0 0 0 0 0 0 0 0 0 0 0 0 0 0 0 0 0 0 0 0 0 0 0 0 0 0 0 0 0
      0 0 0 0 0 0 0 0 0 0 0 0 0 0 0 0 0 0 0 0 0 0 0 0 0 0 0 0 0 0 0 0 0 0 0
      0 0 0 0 0 0 0 0 0 0 0 0 0 0 0 0 0 0 0 0 0 0 0 0 0 0 0 0 0 0 0 0 0 0 0
      0 0 0 0 0 0 0 0 0 0 0 0 0 0 0 0 0 0 0 0 0 0 0 0 0 0 0 0 0 0 0 0 0 0 0
      )
    )
  )
)
