(supertux-level
  (version 2)
  (name (_ "Serano's Islands"))
  (author "alex")
  (target-time 0)
  (sector
    (name "main")
    (music "music/salcon.ogg")
    (ambient-light 1 1 1)
    (sprite-change
      (change-on-touch #t)
      (initial-stay-action #f)
      (sprite "images/worldmap/common/boat/boat.sprite")
      (x 31)
      (y 28)
    )
    (sprite-change
      (change-on-touch #t)
      (initial-stay-action #f)
      (sprite "images/worldmap/common/tux.sprite")
      (x 35)
      (y 37)
    )
    (sprite-change
      (change-on-touch #t)
      (initial-stay-action #f)
      (sprite "images/worldmap/common/boat/boat.sprite")
      (x 35)
      (y 39)
    )
    (sprite-change
      (change-on-touch #t)
      (initial-stay-action #f)
      (sprite "images/worldmap/common/tux.sprite")
      (x 30)
      (y 28)
    )
    (tilemap
      (solid #t)
      (z-pos -100)
      (width 50)
      (height 50)
      (tiles
      9 9 9 9 9 9 9 9 9 9 9 9 9 9 9 9 9 9 9 9 9 9 9 9 9 9 9 9 9 9 9 9 9 9 9 9 9 9 9 9 9 9 9 9 9 9 9 9 9 9
      9 9 9 9 9 9 9 9 9 9 9 9 9 9 9 9 9 9 9 9 9 9 9 9 9 9 9 9 9 9 9 9 9 9 9 9 9 9 9 9 9 9 9 9 9 9 9 9 9 9
      9 9 9 9 9 9 9 9 9 9 9 9 9 9 9 9 9 9 9 9 9 9 9 9 9 9 9 9 9 9 9 9 9 9 9 9 9 9 9 9 9 9 9 9 9 9 9 9 9 9
      9 9 9 9 9 9 9 9 9 9 9 9 9 9 9 9 9 9 9 9 9 9 9 9 9 9 9 9 9 9 9 9 9 9 9 9 9 9 9 9 9 9 9 9 9 9 9 9 9 9
      9 9 9 9 9 9 9 9 9 9 9 9 9 9 9 9 9 9 9 9 9 9 9 9 9 9 9 9 9 9 9 9 9 9 9 9 9 9 9 9 9 9 9 9 9 9 9 9 9 9
      9 9 9 9 9 9 9 9 9 9 9 9 9 9 9 9 9 9 9 9 9 9 9 9 9 9 9 9 9 9 9 9 9 9 9 9 9 9 9 9 9 9 9 9 9 9 9 9 9 9
      9 9 9 9 9 9 9 9 9 9 9 9 9 9 9 9 9 9 9 9 9 9 11 16 12 9 9 9 9 9 9 9 9 9 9 9 9 9 9 9 9 9 9 9 9 9 9 9 9 9
      9 9 9 9 9 9 9 9 9 9 9 9 9 9 9 9 9 9 9 9 9 9 15 19 17 9 9 9 9 9 9 9 9 9 9 9 9 9 9 9 9 9 9 9 9 9 9 9 9 9
      9 9 9 9 9 9 9 9 9 9 9 9 9 9 9 9 9 9 9 9 9 9 14 18 13 9 9 9 9 9 9 9 9 9 9 9 9 9 9 9 9 9 9 9 9 9 9 9 9 9
      9 9 9 9 9 9 9 9 9 9 9 9 9 9 9 9 9 9 9 9 9 9 9 9 9 9 9 9 9 9 9 11 16 16 12 9 9 9 9 9 9 9 9 9 9 9 9 9 9 9
      9 9 9 9 9 9 9 9 9 9 9 9 9 9 9 9 9 11 16 16 16 16 16 16 16 16 16 16 16 16 16 22 19 19 17 9 9 9 9 9 9 9 9 9 9 9 9 9 9 9
      9 9 9 9 9 9 9 9 9 9 9 11 16 12 9 9 11 22 19 19 19 19 19 19 19 19 19 19 19 19 19 19 19 19 17 9 9 9 9 9 9 9 9 9 9 9 9 9 9 9
      9 9 9 9 9 9 9 9 9 9 9 15 58 17 9 11 22 19 48 40 40 40 40 40 40 40 40 40 39 19 24 25 26 19 17 9 9 9 9 9 9 9 9 9 9 9 9 9 9 9
      9 9 9 9 9 9 9 9 11 12 9 15 59 17 9 15 19 19 65 19 19 19 19 19 19 19 19 19 65 19 31 32 27 19 17 9 9 9 9 9 9 9 9 9 9 9 9 9 9 9
      9 9 9 9 9 9 9 9 14 13 9 15 65 17 9 14 18 21 65 19 19 19 19 19 19 19 19 19 65 19 31 32 27 19 17 9 9 9 9 9 9 9 9 9 9 9 9 9 9 9
      9 9 9 9 9 9 9 9 9 9 9 15 65 17 9 9 11 22 65 19 19 19 19 19 24 25 26 19 65 19 31 32 27 19 17 9 9 9 9 9 9 9 9 9 9 9 9 9 9 9
      9 9 9 9 9 9 9 9 9 9 9 15 37 73 74 74 75 40 42 19 19 49 50 51 31 32 27 19 65 19 31 32 27 19 17 9 9 9 9 9 9 9 9 9 9 9 9 9 9 9
      9 9 9 9 9 9 9 9 9 9 9 14 18 13 9 9 15 19 19 19 19 52 53 54 30 29 28 19 65 19 31 32 27 19 23 16 16 16 12 9 9 9 9 9 9 9 9 9 9 9
      9 9 9 9 9 9 9 9 9 9 9 9 9 9 9 11 22 19 48 40 40 77 76 57 40 40 40 40 42 24 33 32 27 19 19 19 19 19 17 9 9 9 9 9 9 9 9 9 9 9
      9 9 9 9 9 9 9 9 9 9 9 9 9 9 9 15 19 19 47 19 19 19 19 19 19 19 19 19 19 30 36 35 28 19 20 18 18 18 13 9 9 9 9 9 9 9 9 9 9 9
      9 9 9 9 9 9 9 9 9 9 9 9 9 11 16 22 19 19 47 19 19 19 19 19 19 19 19 19 19 19 30 28 19 19 17 9 9 9 9 9 9 9 9 9 9 9 9 9 9 9
      9 9 9 9 9 9 9 9 9 9 9 9 9 14 18 18 21 19 41 40 40 40 40 39 19 19 19 19 19 19 19 19 19 19 17 9 9 11 12 9 9 9 9 9 9 9 9 9 9 9
      9 9 9 9 9 9 9 9 9 9 9 9 9 9 9 9 15 19 47 19 19 19 19 47 19 60 20 18 18 18 18 21 19 19 17 9 9 15 17 9 9 9 9 9 9 9 9 9 9 9
      9 9 9 9 9 9 9 9 9 9 9 9 9 9 9 9 15 19 47 19 19 19 19 47 20 18 13 9 9 9 9 14 18 18 13 9 9 14 13 9 9 9 9 9 9 9 9 9 9 9
      9 9 9 9 9 9 9 9 9 9 9 9 9 9 9 9 15 19 41 40 40 40 40 42 17 9 9 9 9 9 9 9 9 9 9 9 9 9 9 9 9 9 9 9 9 9 9 9 9 9
      9 9 9 9 9 9 9 9 9 9 9 9 9 9 9 9 15 19 47 19 24 25 26 19 17 9 9 9 9 9 9 9 9 9 9 9 9 9 9 9 9 9 9 9 9 9 9 9 9 9
      9 9 9 9 9 9 9 9 9 9 9 9 9 9 9 11 22 19 47 19 30 29 28 19 17 9 9 9 9 9 9 9 9 9 9 9 9 9 9 9 9 9 9 9 9 9 9 9 9 9
      9 9 9 9 9 9 9 9 9 9 9 9 9 9 9 15 19 19 47 19 19 19 19 19 23 16 16 16 16 16 16 16 12 9 9 9 9 9 9 9 9 9 9 9 9 9 9 9 9 9
      9 9 9 9 9 9 9 9 9 9 9 9 9 9 9 15 19 19 37 40 40 40 40 40 40 66 66 66 66 66 66 66 915 63 63 63 63 63 63 81 9 9 9 9 9 9 9 9 9 9
      9 9 9 9 9 9 9 9 9 9 9 9 9 9 9 15 19 19 19 19 19 19 20 18 18 18 18 18 18 18 18 18 13 9 9 9 9 9 9 79 9 9 9 9 9 9 9 9 9 9
      9 9 9 9 9 9 9 9 9 9 9 9 9 9 9 14 18 18 18 18 18 18 13 9 9 9 9 9 9 9 9 9 9 9 9 9 9 9 9 79 9 9 9 9 9 9 9 9 9 9
      9 9 9 9 9 9 9 9 9 9 9 9 9 9 9 9 9 9 9 9 9 9 9 9 9 9 9 9 9 9 9 9 9 417 9 9 9 9 9 79 9 9 417 9 9 9 9 9 9 9
      9 9 9 9 9 9 9 9 9 9 9 9 9 9 9 9 9 9 9 9 9 9 9 9 9 9 9 9 9 9 9 9 9 9 9 9 9 9 9 79 9 9 9 9 9 9 9 9 9 9
      9 9 9 9 9 9 9 9 9 9 9 9 9 9 9 9 9 9 9 9 9 9 9 9 9 9 9 9 9 9 9 9 9 9 9 9 9 9 9 79 9 9 9 9 9 9 9 9 9 9
      9 9 9 9 9 9 9 9 9 9 9 9 9 9 9 9 794 804 804 804 804 804 804 804 804 804 804 804 795 9 9 9 9 9 9 9 9 9 9 79 9 9 9 794 795 9 9 9 9 9
      9 9 9 9 9 9 9 9 9 9 9 9 9 9 9 794 798 798 798 798 798 798 798 798 798 798 798 798 798 804 804 804 804 804 804 804 795 9 9 79 9 9 9 808 800 9 9 9 9 9
      9 9 9 9 9 9 9 9 9 9 9 9 9 9 9 808 790 790 790 790 790 790 790 402 406 406 406 406 406 406 406 406 406 406 406 405 800 9 9 79 9 9 9 792 793 9 9 9 9 9
      9 9 9 9 9 9 9 9 9 9 9 9 9 9 9 808 790 790 790 790 790 790 790 409 790 790 790 790 790 790 790 790 790 870 809 767 793 9 9 79 9 9 9 9 9 9 9 9 9 9
      9 9 9 9 9 9 9 9 9 9 9 9 9 9 9 792 818 790 871 872 790 790 790 409 790 870 871 872 873 874 875 876 877 870 800 772 9 9 9 79 9 9 9 9 9 9 9 9 9 9
      9 9 9 9 9 9 9 9 9 9 9 9 9 9 9 9 808 790 880 881 790 790 790 409 790 880 880 881 882 883 884 885 886 887 800 84 78 78 78 85 9 9 9 9 9 9 9 9 9 9
      9 9 9 9 9 9 9 9 9 9 9 9 9 9 9 9 808 790 790 790 790 790 790 409 790 888 889 890 891 892 893 894 895 896 800 9 9 9 9 9 9 9 417 9 9 9 9 9 9 9
      9 9 9 9 9 9 9 9 9 9 9 9 9 9 9 9 808 790 790 790 802 803 790 409 870 897 898 899 900 901 902 903 904 905 870 795 9 9 9 9 9 9 9 9 9 9 9 9 9 9
      9 9 9 9 9 9 9 9 9 9 9 9 9 9 9 9 792 818 790 790 811 812 790 409 870 870 898 907 908 909 910 911 912 913 870 870 804 804 804 804 804 795 9 9 9 9 9 9 9 9
      9 9 9 9 9 9 9 9 9 9 9 9 9 9 9 9 9 808 790 790 790 790 790 404 406 406 406 406 406 406 406 406 406 406 406 406 406 406 406 405 790 800 9 9 9 9 9 9 9 9
      9 9 9 9 9 9 9 9 9 9 9 9 9 9 9 9 9 792 801 801 801 818 790 790 790 790 790 790 790 790 790 790 790 790 790 790 790 790 790 409 790 800 9 9 9 9 9 9 9 9
      9 9 9 9 9 9 9 9 9 9 9 9 9 9 9 9 9 640 640 640 640 792 801 818 790 790 790 790 790 790 790 790 790 790 790 790 790 790 790 409 790 800 9 9 794 795 9 9 9 9
      9 9 9 9 9 9 9 9 9 9 9 9 9 9 9 9 9 640 640 640 640 640 640 792 801 801 801 818 790 790 790 790 790 402 406 406 406 406 406 413 790 800 9 9 791 799 795 9 9 9
      9 9 9 9 9 9 9 9 9 9 9 9 9 9 9 9 9 640 640 640 640 640 640 640 640 640 640 792 801 801 801 801 801 767 801 818 790 790 790 790 790 800 9 9 792 801 793 9 9 9
      9 9 9 9 9 9 9 9 9 9 9 9 9 9 9 9 9 640 640 640 640 640 640 640 640 640 640 640 640 640 640 640 640 772 640 792 801 801 801 801 801 793 640 9 9 9 9 9 9 9
      9 9 9 9 9 9 9 9 9 9 9 9 9 9 9 9 9 640 640 640 640 640 640 640 640 640 640 640 640 640 640 640 640 640 640 640 640 640 640 640 640 640 640 9 9 9 9 9 9 9
      )
    )
    (level
      (name "doom.stl")
      (sprite "images/worldmap/common/leveldot.sprite")
      (x 14)
      (y 16)
    )
    (level
      (name "horizont.stl")
      (sprite "images/worldmap/common/leveldot.sprite")
      (x 18)
      (y 13)
    )
    (level
      (name "schnee1.stl")
      (sprite "images/worldmap/common/leveldot.sprite")
      (x 23)
      (y 12)
    )
    (level
      (name "bitte.stl")
      (sprite "images/worldmap/common/leveldot.sprite")
      (x 22)
      (y 18)
    )
    (level
      (name "schnee2.stl")
      (sprite "images/worldmap/common/leveldot.sprite")
      (x 28)
      (y 15)
    )
    (level
      (name "diamant1.stl")
      (x 18)
      (y 21)
    )
    (level
      (name "diamant2.stl")
      (x 23)
      (y 22)
    )
    (level
      (name "bitter.stl")
      (x 18)
      (y 27)
    )
    (level
      (name "gebirge.stl")
      (x 23)
      (y 28)
    )
    (level
      (name "vergnuegen.stl")
      (x 30)
      (y 28)
    )
    (level
      (name "daemwa.stl")
      (sprite "images/worldmap/common/shroom.sprite")
      (x 31)
      (y 36)
    )
    (level
      (name "baum.stl")
      (sprite "images/worldmap/common/shroom.sprite")
      (x 25)
      (y 36)
    )
    (level
      (name "huegel.stl")
      (sprite "images/worldmap/common/shroom.sprite")
      (x 23)
      (y 38)
    )
    (level
      (name "laby.stl")
      (sprite "images/worldmap/common/shroom.sprite")
      (x 23)
      (y 41)
    )
    (level
      (name "wuw.stl")
      (sprite "images/worldmap/common/shroom.sprite")
      (x 27)
      (y 43)
    )
    (level
      (name "riswa.stl")
      (sprite "images/worldmap/common/shroom.sprite")
      (x 33)
      (y 43)
    )
    (level
      (name "twald.stl")
      (sprite "images/worldmap/common/shroom.sprite")
      (x 39)
      (y 45)
    )
    (worldmap-spawnpoint
      (name "main")
      (x 12)
      (y 13)
    )
  )
  (tileset "images/worldmap.strf")
)
