(supertux-level
  (version 2)
  (name (_ "Mattie's Iceberg"))
  (author "LMH")
  (license "GPL 2 / CC-by-sa 3.0")
  (target-time 0)
  (sector
    (name "main")
    (music "music/salcon.ogg")
    (init-script "map <- true;
if(false){  import(\"levels/mattie_world/mattie_iceberg/default.nut\");}
if(!state.easy){
  print(\"[DEBUG] Wrong worldmap difficulty loaded, compensating.\\n\");
  exit_screen();
  load_worldmap(\"levels/mattie_world/worldmap.stwm\");
}    ")
    (ambient-light 1 1 1)
    (teleporter
      (worldmap "levels/mattie_world/easyworldmap.stwm")
      (spawnpoint "main")
      (message (_ "Go home"))
      (sprite "images/worldmap/common/teleporterdot.sprite")
      (x 6)
      (y 21)
    )
    (tilemap
      (solid #t)
      (z-pos 0)
      (name "pathing")
      (width 40)
      (height 30)
      (tiles
      0 0 0 0 0 0 0 0 0 0 0 0 0 0 0 0 0 0 0 0 0 0 0 0 0 0 0 0 0 0 0 0 0 0 0 0 0 0 0 0
      0 0 0 0 0 0 0 0 0 0 0 0 0 0 0 0 0 0 0 0 0 0 0 0 0 0 0 0 0 0 0 0 0 0 0 0 0 0 0 0
      0 0 0 0 0 0 0 0 0 0 0 0 0 0 0 0 0 0 0 0 0 0 0 0 0 0 0 0 0 0 0 0 0 0 0 0 0 0 0 0
      0 0 0 0 0 0 0 0 0 0 0 0 0 0 0 0 0 0 0 0 0 0 0 0 0 0 0 0 0 0 0 0 0 0 0 0 0 0 0 0
      0 0 0 0 0 0 0 0 0 0 0 2030 2040 2040 2040 2040 2040 2040 2031 0 0 0 0 0 0 0 0 0 0 0 0 0 0 0 0 0 0 0 0 0
      0 0 0 0 0 0 0 0 0 0 0 2041 0 0 0 2039 0 0 2041 0 0 0 0 0 0 0 0 0 0 0 0 0 0 0 0 0 0 0 0 0
      0 0 0 0 0 0 0 0 0 0 0 2041 0 0 0 2044 0 0 2041 0 0 0 0 0 0 0 0 0 0 0 0 0 0 0 0 0 0 0 0 0
      0 0 0 0 0 0 0 0 0 0 0 2041 0 0 0 47 0 0 2034 2040 2040 2031 0 0 0 0 0 0 0 0 0 0 0 0 0 0 0 0 0 0
      0 0 0 0 0 0 0 0 0 0 0 2034 2040 2040 2040 47 0 0 0 0 0 2034 2040 2043 0 0 0 0 0 0 0 0 0 0 0 0 0 0 0 0
      0 0 0 0 0 0 0 0 0 0 0 0 48 40 40 44 40 40 40 40 40 39 0 0 0 0 0 0 0 0 0 0 0 0 0 0 0 0 0 0
      0 0 0 0 0 0 0 0 0 0 0 48 42 0 0 0 0 0 0 0 0 47 0 0 0 0 0 0 0 0 0 0 0 0 0 0 0 0 0 0
      0 0 0 0 0 0 0 0 0 0 0 47 0 0 0 0 0 0 0 0 0 47 0 0 0 0 0 0 0 0 0 0 0 0 0 0 0 0 0 0
      0 0 0 0 0 0 0 0 0 0 0 47 0 0 0 0 0 0 0 0 0 47 0 0 0 0 0 0 0 0 0 0 0 0 0 0 0 0 0 0
      0 0 0 0 0 0 0 0 0 0 0 47 0 0 0 0 0 0 0 0 0 47 0 0 0 0 0 0 0 0 0 0 0 0 0 0 0 0 0 0
      0 0 0 0 0 2030 2031 0 0 0 0 47 0 0 0 0 0 0 0 48 40 42 0 0 0 0 0 0 0 0 0 0 0 0 0 0 0 0 0 0
      0 0 0 0 0 2041 2038 2040 2040 2040 2031 47 0 48 40 40 40 40 43 42 0 0 0 0 0 0 0 0 0 0 0 0 0 0 0 0 0 0 0 0
      0 0 0 0 0 2034 2040 2040 2031 0 2034 37 40 42 0 0 0 0 47 0 0 0 0 0 0 0 0 0 0 0 0 0 0 0 0 0 0 0 0 0
      0 0 0 0 0 0 0 0 2034 2040 2040 2040 2031 0 0 0 0 0 47 0 0 0 0 0 0 0 0 0 0 0 0 0 0 0 0 2041 0 0 0 0
      0 0 0 0 0 0 0 0 0 0 0 0 2034 2031 0 0 0 0 37 40 40 40 40 39 0 0 0 0 0 0 0 0 0 0 0 2041 0 0 0 0
      0 0 0 0 0 0 0 0 2033 0 0 0 0 2041 0 0 0 0 0 2033 2040 2040 2043 47 2038 2040 2040 2040 2040 2040 2040 2040 2040 2040 2040 2035 0 0 0 0
      0 0 0 0 0 0 0 0 0 0 0 0 0 2042 0 0 0 0 2045 2041 0 48 40 42 0 0 0 0 0 0 0 0 0 0 0 0 0 0 0 0
      0 0 0 0 0 0 69 40 40 40 73 74 75 40 40 39 0 0 2030 2035 48 42 0 0 0 0 0 0 0 0 0 0 0 0 0 0 0 0 0 0
      0 0 0 0 0 0 0 0 0 0 0 0 0 0 0 37 40 40 40 40 42 0 0 0 0 0 0 0 0 0 0 0 0 0 0 0 0 0 0 0
      0 0 0 0 0 0 0 0 0 0 0 0 0 0 0 0 0 0 0 0 0 0 0 0 0 0 0 0 0 0 0 0 0 0 0 0 0 0 0 0
      0 0 0 0 0 0 0 0 0 0 0 0 0 0 0 0 0 0 0 0 0 0 0 0 0 0 0 0 0 0 0 0 0 0 0 0 0 0 0 0
      0 0 0 0 0 0 0 0 0 0 0 0 0 0 0 0 0 0 0 0 0 0 0 0 0 0 0 0 0 0 0 0 0 0 0 0 0 0 0 0
      0 0 0 0 0 0 0 0 0 0 0 0 0 0 0 0 0 0 0 0 0 0 0 0 0 0 0 0 0 0 0 0 0 0 0 0 0 0 0 0
      0 0 0 0 0 0 0 0 0 0 0 0 0 0 0 0 0 0 0 0 0 0 0 0 0 0 0 0 0 0 0 0 0 0 0 0 0 0 0 0
      0 0 0 0 0 0 0 0 0 0 0 0 0 0 0 0 0 0 0 0 0 0 0 0 0 0 0 0 0 0 0 0 0 0 0 0 0 0 0 0
      0 0 0 0 0 0 0 0 0 0 0 0 0 0 0 0 0 0 0 0 0 0 0 0 0 0 0 0 0 0 0 0 0 0 0 0 0 0 0 0
      )
    )
    (tilemap
      (solid #f)
      (z-pos -100)
      (name "background")
      (width 40)
      (height 30)
      (tiles
      9 9 9 9 9 9 9 9 9 9 9 9 9 9 9 9 9 9 9 9 9 9 9 9 9 9 9 9 9 9 9 9 9 9 9 9 9 9 9 9
      9 9 9 9 9 9 9 9 9 9 9 19 9 9 9 9 9 9 9 9 9 9 9 9 9 9 9 9 9 9 9 9 9 9 9 9 9 9 9 9
      9 9 9 9 9 9 9 9 9 9 9 19 19 9 9 9 9 9 9 9 9 9 9 9 9 9 9 9 9 9 9 9 9 9 9 9 9 9 9 9
      9 9 9 9 9 9 9 9 9 9 19 19 19 19 19 19 9 9 9 9 9 9 9 9 9 9 9 9 9 9 9 9 9 9 9 9 9 9 9 9
      9 9 9 9 9 9 9 9 9 19 19 19 19 19 19 19 9 9 9 9 9 19 9 9 9 9 9 9 9 9 9 9 9 9 9 9 9 9 9 9
      9 9 9 9 9 9 9 19 19 19 19 19 19 19 19 0 19 19 19 9 9 19 19 19 19 9 9 9 9 9 9 9 19 9 9 9 9 9 9 9
      9 9 9 9 9 9 9 19 19 19 19 19 19 19 19 0 19 19 19 19 19 19 19 19 9 9 9 9 9 9 9 9 9 9 9 9 9 9 9 9
      9 9 9 9 9 9 9 9 9 19 19 19 19 19 19 19 19 19 19 19 19 19 19 19 9 9 9 9 9 9 9 9 9 9 9 9 9 9 9 9
      9 9 9 9 9 9 9 9 9 19 19 19 19 19 19 19 19 19 19 19 19 19 19 19 19 9 9 9 9 9 9 9 9 9 9 9 9 9 9 9
      9 9 9 9 9 9 9 9 9 19 19 19 19 19 19 19 19 19 19 19 19 19 19 19 19 19 19 9 9 9 9 9 9 9 9 9 9 9 9 9
      9 9 9 9 9 9 9 19 19 19 19 19 19 19 19 19 19 19 19 19 19 19 19 19 19 9 9 9 9 9 9 9 9 19 19 9 9 9 9 9
      9 9 9 9 9 9 19 19 19 19 19 19 19 19 19 19 19 19 19 19 19 19 19 19 9 9 9 9 9 9 9 9 9 19 19 19 19 9 9 9
      9 9 9 9 9 9 19 19 19 19 19 19 19 19 19 19 19 19 19 19 19 19 19 19 9 9 9 9 9 9 9 9 19 19 19 19 19 19 19 9
      9 9 9 9 9 9 9 19 19 19 19 19 19 19 19 19 19 19 19 19 19 19 19 19 9 9 9 9 9 9 9 19 19 19 19 19 19 19 9 9
      9 9 9 9 9 9 9 19 19 19 19 19 19 19 19 19 19 19 19 19 19 19 19 19 9 9 9 9 9 9 9 19 19 19 19 19 19 19 9 9
      9 9 9 9 9 9 19 19 19 19 19 19 19 19 19 19 19 19 19 19 19 19 19 19 19 19 19 9 9 9 9 9 19 19 19 19 19 19 9 9
      9 9 9 9 9 19 19 19 19 19 19 19 19 19 19 19 19 19 19 19 19 19 19 19 19 19 19 9 9 9 9 9 9 19 19 19 19 9 9 9
      9 9 9 9 9 9 9 9 9 9 9 9 9 19 19 19 19 19 19 19 19 19 19 19 19 19 19 19 9 9 9 9 9 19 19 19 19 9 9 9
      9 9 9 19 19 9 9 9 9 9 9 9 9 19 19 19 19 19 19 19 19 19 19 19 19 19 19 19 9 9 9 9 9 9 9 19 9 9 9 9
      9 9 9 19 9 9 9 19 19 19 19 9 9 19 19 19 19 19 19 19 19 19 19 19 19 19 19 19 9 9 9 9 9 9 9 9 9 9 9 9
      9 9 19 19 9 9 9 19 19 19 9 9 9 19 19 19 19 19 19 19 19 19 19 19 19 19 19 9 9 9 9 9 9 9 9 9 9 9 9 9
      9 9 19 19 9 9 19 19 19 19 9 9 9 19 19 19 19 19 19 19 19 19 19 19 19 19 9 9 9 9 9 9 9 9 9 9 9 9 9 9
      9 9 19 19 9 9 9 19 19 19 9 9 9 19 19 19 19 19 19 19 19 19 19 19 19 19 9 9 9 9 9 9 9 9 9 9 9 9 9 9
      9 19 19 19 9 9 9 9 9 9 9 9 9 19 19 19 19 19 19 19 19 19 19 19 19 19 9 9 9 9 9 9 9 9 9 9 9 9 9 9
      9 19 19 19 19 9 9 9 9 9 9 9 9 19 19 9 9 19 19 19 19 19 19 19 19 19 19 19 19 19 9 9 9 9 9 9 9 9 9 9
      9 9 19 19 19 19 19 19 19 19 19 19 19 9 9 9 9 9 9 9 9 19 19 19 19 19 19 19 19 9 9 9 9 9 9 9 9 9 9 9
      9 9 19 9 9 9 9 9 19 19 19 19 9 9 9 9 9 9 9 9 9 9 9 9 9 9 19 9 9 9 9 9 9 9 9 9 9 9 9 9
      9 9 9 9 9 9 9 9 9 9 9 9 9 9 9 9 9 9 9 9 9 9 9 9 9 9 9 9 9 9 9 9 9 9 9 9 9 9 9 9
      9 9 9 9 9 9 9 9 9 9 9 9 9 9 9 9 9 9 9 9 9 9 9 9 9 9 9 9 9 9 9 9 9 9 9 9 9 9 9 9
      9 9 9 9 9 9 9 9 9 9 9 9 9 9 9 9 9 9 9 9 9 9 9 9 9 9 9 9 9 9 9 9 9 9 9 9 9 9 9 9
      )
    )
    (tilemap
      (solid #f)
      (z-pos -10)
      (name "backdetail")
      (width 40)
      (height 30)
      (tiles
      0 0 0 0 0 0 11 12 0 0 11 16 12 0 0 0 0 0 0 0 0 0 0 0 0 0 0 0 0 0 0 0 0 0 0 0 0 0 0 0
      0 0 0 0 11 16 22 17 0 0 15 0 23 12 0 0 0 0 0 0 0 0 0 0 0 0 0 0 0 0 0 0 0 0 0 0 0 0 0 0
      0 0 0 0 15 20 18 13 0 11 22 24 26 23 16 16 12 0 0 0 0 0 0 0 0 0 0 0 0 0 0 0 0 0 0 0 0 0 0 0
      0 11 12 0 14 13 0 0 11 22 0 31 27 24 25 26 17 0 0 0 11 16 12 0 0 0 0 0 0 0 0 0 0 0 0 0 0 0 0 0
      0 14 13 0 0 11 16 16 22 24 25 33 34 33 35 28 23 16 16 12 15 0 23 16 16 12 0 0 0 0 0 11 16 12 0 0 0 0 0 0
      0 0 0 0 0 14 21 0 24 33 35 36 32 32 27 58 24 25 26 23 22 2181 2187 0 0 23 12 0 0 0 11 22 0 17 0 0 0 0 0 0
      0 0 0 0 0 0 15 0 30 36 34 33 32 32 27 59 31 35 28 0 2171 2182 2188 2179 20 18 13 0 0 0 14 18 21 23 12 0 0 0 0 0
      0 0 0 0 0 0 14 18 21 30 36 32 35 29 28 0 31 27 0 0 2172 2183 2189 2180 23 12 0 0 0 0 0 0 14 18 13 0 0 0 0 0
      0 0 11 12 0 0 0 0 15 0 30 29 28 0 0 0 30 28 2172 2180 0 0 0 0 0 23 16 12 0 0 0 0 0 0 0 0 0 0 0 0
      0 11 22 17 0 0 11 16 22 0 2172 2180 0 0 0 0 0 0 0 0 2204 2205 2206 0 0 0 0 17 0 0 0 0 11 16 16 12 0 0 0 0
      0 14 18 13 0 11 22 2181 2187 0 0 0 0 33 34 25 2172 2183 0 0 2207 2208 2215 2206 0 20 18 13 0 0 0 0 15 0 0 23 16 12 0 0
      0 0 0 0 0 15 2171 2182 2188 2179 0 0 31 35 36 32 32 34 25 26 2210 2214 2208 2209 20 13 0 0 0 0 0 11 22 0 0 0 0 23 16 12
      0 0 0 0 0 15 2172 2183 2189 2180 0 0 31 34 33 35 36 32 32 34 26 2207 2208 2215 17 0 0 0 0 0 11 22 0 0 0 0 0 0 0 17
      0 0 0 0 0 14 21 0 0 0 0 0 31 35 36 34 33 32 35 29 28 2210 2214 2213 17 0 0 0 0 0 15 0 0 0 0 0 0 0 20 13
      0 0 0 0 0 11 22 0 0 0 0 0 30 28 30 29 29 29 28 0 0 2204 2216 2209 23 16 16 12 0 0 15 0 0 0 0 0 0 0 17 0
      0 0 0 0 11 22 0 0 24 26 0 0 0 0 0 0 0 0 0 2204 2205 2216 2217 2215 2206 0 0 17 0 0 14 21 0 0 0 0 0 0 17 0
      11 12 0 0 15 0 0 0 30 28 0 0 0 0 0 24 25 26 0 2210 2211 2211 2211 2214 2215 2206 0 23 12 0 0 14 21 0 0 0 0 20 13 0
      14 13 11 16 22 20 18 18 18 18 18 18 21 0 0 30 36 27 0 0 52 53 54 2210 2211 2212 0 0 17 0 0 0 15 0 0 0 0 17 0 0
      0 0 15 0 0 17 11 16 16 16 16 12 15 24 25 25 33 34 0 0 55 56 57 0 0 0 0 0 17 0 0 0 14 18 21 0 20 13 0 0
      0 11 22 0 20 13 15 49 50 51 0 17 15 31 35 36 35 29 28 0 0 0 0 0 24 0 0 0 23 12 0 0 0 0 14 18 13 0 0 0
      0 15 24 26 17 11 22 52 53 54 20 13 15 30 28 30 28 52 54 0 0 0 0 0 31 0 0 20 18 13 0 0 0 0 0 0 0 0 0 0
      0 15 31 27 17 15 0 55 56 57 17 0 15 0 0 0 0 52 54 0 0 0 0 0 30 28 20 13 0 0 0 0 0 0 0 0 0 0 0 0
      11 22 30 28 17 14 21 60 0 0 17 0 15 2172 2180 0 0 55 57 0 0 24 25 33 34 26 17 11 12 0 0 0 0 0 0 0 0 0 0 0
      15 24 25 25 23 12 14 18 18 18 13 0 15 0 0 0 0 52 54 24 25 33 32 32 35 28 23 22 23 16 12 0 0 0 0 0 0 0 0 0
      15 30 29 29 28 23 16 16 16 16 16 16 22 0 0 20 21 52 54 30 29 29 29 29 28 0 0 0 0 0 17 0 0 0 0 0 0 0 0 0
      14 21 0 0 14 0 0 0 0 0 0 0 0 20 18 13 14 18 18 18 21 0 0 0 0 0 0 0 0 20 13 0 0 0 0 0 0 0 0 0
      0 15 0 20 18 18 18 21 0 0 0 0 20 13 0 0 0 0 0 0 14 18 21 20 18 21 0 20 18 13 0 0 0 0 0 0 0 0 0 0
      0 14 18 13 0 0 0 14 18 18 18 18 13 0 0 0 0 0 0 0 0 0 14 13 0 14 18 13 0 0 0 0 0 0 0 0 0 0 0 0
      0 0 0 0 0 0 0 0 0 0 0 0 0 0 0 0 0 0 0 0 0 0 0 0 0 0 0 0 0 0 0 0 0 0 0 0 0 0 0 0
      0 0 0 0 0 0 0 0 0 0 0 0 0 0 0 0 0 0 0 0 0 0 0 0 0 0 0 0 0 0 0 0 0 0 0 0 0 0 0 0
      )
    )
    (tilemap
      (solid #f)
      (z-pos 100)
      (name "foredetail")
      (width 40)
      (height 30)
      (tiles
      0 0 0 0 0 0 0 0 0 0 0 0 0 0 0 0 0 0 0 0 0 0 0 0 0 0 0 0 0 0 0 0 0 0 0 0 0 0 0 0
      0 0 0 0 0 0 0 0 0 0 0 0 0 0 0 0 0 0 0 0 0 0 0 0 0 0 0 0 0 0 0 0 0 0 0 0 0 0 0 0
      0 0 0 0 0 0 0 0 0 0 0 0 0 0 0 0 0 0 0 0 0 0 0 0 0 0 0 0 0 0 0 0 0 0 0 0 0 0 0 0
      0 0 0 0 0 0 0 0 0 0 0 0 0 0 0 0 0 0 0 0 0 0 0 0 0 0 0 0 0 0 0 0 0 0 0 0 0 0 0 0
      0 0 0 0 0 0 0 0 0 0 0 0 0 0 0 0 0 0 0 0 0 0 0 0 0 0 0 0 0 0 0 0 0 0 0 0 0 0 0 0
      0 0 0 0 0 0 0 0 0 0 0 0 0 0 0 0 0 0 0 0 0 0 0 0 0 0 0 0 0 0 0 0 0 0 0 0 0 0 0 0
      0 0 0 0 0 0 0 0 0 0 0 0 0 0 0 0 0 0 0 0 0 0 0 0 0 0 0 0 0 0 0 0 0 0 0 0 0 0 0 0
      0 0 0 0 0 0 0 0 0 0 0 0 0 0 0 0 0 0 2171 2179 0 24 25 25 26 0 0 0 0 0 0 0 0 0 0 0 0 0 0 0
      0 0 0 0 0 0 0 0 0 0 2171 2179 0 0 0 0 0 0 0 0 0 30 36 35 28 0 0 0 0 0 0 0 0 0 0 0 0 0 0 0
      0 0 0 0 0 0 0 0 2171 2179 0 0 0 24 26 0 2171 2173 2175 2177 2179 0 30 28 0 0 0 0 0 0 0 0 0 0 24 26 0 0 0 0
      0 0 0 0 0 0 0 0 2172 2180 0 0 24 0 0 0 25 26 2176 2178 2180 0 24 26 0 0 0 0 0 0 0 0 0 24 33 34 25 26 0 0
      0 0 0 0 0 0 0 0 0 0 0 0 0 0 0 0 0 0 0 0 0 0 31 27 0 0 0 0 0 0 0 0 24 33 35 36 32 27 0 0
      0 0 0 0 0 0 2171 2173 2175 2177 2179 0 0 0 0 0 0 0 0 0 0 0 30 28 2206 0 0 0 0 0 0 0 31 32 34 33 35 28 0 0
      0 0 0 0 0 0 2172 2174 2176 2178 2180 0 0 0 0 0 0 0 0 0 0 0 0 0 2212 0 0 0 0 0 0 24 33 35 36 32 34 26 0 0
      0 0 0 0 0 0 0 0 0 0 0 0 0 0 0 0 0 0 0 0 0 0 0 0 0 0 0 0 0 0 0 30 36 34 33 32 32 27 0 0
      0 0 0 0 0 0 0 0 0 0 0 0 0 0 0 0 0 0 0 0 0 0 0 0 0 24 25 26 0 0 0 0 30 36 32 32 32 27 0 0
      0 0 0 0 0 0 0 0 0 0 0 0 0 24 26 0 0 0 0 0 49 50 51 0 24 33 32 27 0 0 0 0 0 30 36 32 35 28 0 0
      0 0 0 24 26 0 0 0 0 0 0 0 0 30 28 0 0 0 0 0 0 0 0 0 31 32 35 28 0 0 0 0 0 0 30 29 28 0 0 0
      0 0 0 30 28 0 0 0 0 0 0 0 0 0 0 0 0 0 26 0 0 0 0 0 30 36 27 0 0 0 0 0 0 0 0 0 0 0 0 0
      0 0 0 0 0 0 0 0 0 0 0 0 0 0 0 0 0 49 51 0 0 0 0 0 24 33 34 26 0 0 0 0 0 0 0 0 0 0 0 0
      0 0 0 0 0 0 0 0 0 0 0 0 0 0 0 0 0 49 51 0 0 0 0 0 31 35 29 28 0 0 0 0 0 0 0 0 0 0 0 0
      0 0 0 0 0 0 0 0 0 0 0 0 0 2171 2179 0 0 0 0 0 0 0 0 24 26 28 0 0 0 0 0 0 0 0 0 0 0 0 0 0
      0 0 0 0 0 0 0 0 0 0 0 0 0 24 25 26 0 49 51 0 0 0 0 0 0 0 0 0 0 0 0 0 0 0 0 0 0 0 0 0
      0 0 0 0 26 0 0 0 0 0 0 0 0 31 35 28 0 49 51 0 0 0 2181 2184 2187 0 0 0 0 0 0 0 0 0 0 0 0 0 0 0
      0 0 0 0 24 25 25 25 25 25 26 24 26 30 28 0 0 0 0 0 0 2171 2182 2185 2188 2173 2175 2177 2179 0 0 0 0 0 0 0 0 0 0 0
      0 0 0 0 30 29 29 29 36 32 34 33 27 0 0 0 0 55 57 0 0 2172 2183 2186 2189 2174 2176 2178 2180 0 0 0 0 0 0 0 0 0 0 0
      0 0 0 0 0 0 0 0 30 29 29 29 28 0 0 0 0 0 0 0 0 0 0 0 0 0 0 0 0 0 0 0 0 0 0 0 0 0 0 0
      0 0 0 0 0 0 0 0 0 0 0 0 0 0 0 0 0 0 0 0 0 0 0 0 0 0 0 0 0 0 0 0 0 0 0 0 0 0 0 0
      0 0 0 0 0 0 0 0 0 0 0 0 0 0 0 0 0 0 0 0 0 0 0 0 0 0 0 0 0 0 0 0 0 0 0 0 0 0 0 0
      0 0 0 0 0 0 0 0 0 0 0 0 0 0 0 0 0 0 0 0 0 0 0 0 0 0 0 0 0 0 0 0 0 0 0 0 0 0 0 0
      )
    )
    (level
      (name "mattie_iceberg/E_DOOM.stl")
      (x 15)
      (y 8)
    )
    (level
      (name "mattie_iceberg/E_Fields.stl")
      (x 15)
      (y 9)
    )
    (level
      (name "mattie_iceberg/E_Quarry.stl")
      (x 13)
      (y 9)
    )
    (level
      (name "mattie_iceberg/E_Mineshaft.stl")
      (x 11)
      (y 12)
    )
    (level
      (name "mattie_iceberg/E_Dungeon.stl")
      (x 11)
      (y 16)
    )
    (level
      (name "mattie_iceberg/E_Cavern.stl")
      (x 18)
      (y 15)
    )
    (level
      (name "mattie_iceberg/E_HighRoute.stl")
      (x 19)
      (y 9)
    )
    (level
      (name "mattie_iceberg/E_ScarySkies.stl")
      (x 21)
      (y 11)
    )
    (level
      (name "mattie_iceberg/GardenCastle.stl")
      (x 21)
      (y 18)
    )
    (level
      (name "mattie_iceberg/E_ThreeLanterns.stl")
      (x 21)
      (y 21)
    )
    (level
      (name "mattie_iceberg/E_Wall.stl")
      (x 18)
      (y 22)
    )
    (level
      (name "mattie_iceberg/E_MtnPass.stl")
      (x 14)
      (y 21)
    )
    (level
      (name "mattie_iceberg/E_Moat.stl")
      (x 11)
      (y 21)
    )
    (level
      (name "mattie_iceberg/MysteriousCastle.stl")
      (x 8)
      (y 21)
    )
    (level
      (name "mattie_iceberg/E_Escape.stl")
      (extro-script "  wait_for_screenswitch();
        display_text_file(  \"levels/mattie_world/mattie_iceberg/iceberg_end.txt\"  );  ")
      (x 7)
      (y 21)
    )
    (level
      (name "TimeWarp.stl")
      (sprite "images/worldmap/common/hiddendot.sprite")
      (x 15)
      (y 5)
    )
    (worldmap-spawnpoint
      (name "main")
      (x 15)
      (y 6)
    )
    (worldmap-spawnpoint
      (name "islands")
      (x 6)
      (y 21)
    )
  )
  (tileset "images/LMH_iceberg_worldmap.strf")
)
