(supertux-level
  (version 2)
  (name (_ "Mattie's Iceberg"))
  (author "LMH")
  (license "GPL 2 / CC-by-sa 3.0")
  (target-time 0)
  (sector
    (name "main")
    (music "music/salcon.ogg")
    (init-script "map <- true;
state.coin_level_active <- false;
if(false){  import(\"levels/mattie_world/mattie_iceberg/default.nut\");}
if(!state.hard){
  print(\"[DEBUG] Wrong worldmap difficulty loaded, compensating.\\n\");
  exit_screen();
  load_worldmap(\"levels/mattie_world/worldmap.stwm\");
 }")
    (ambient-light 1 1 1)
    (teleporter
      (worldmap "levels/mattie_world/doom_islands/worldmap.stwm")
      (spawnpoint "main")
      (message (_ "Preview of DOOM Islands"))
      (sprite "images/worldmap/common/teleporterdot.sprite")
      (x 6)
      (y 21)
    )
    (tilemap
      (solid #t)
      (z-pos 0)
      (name "pathing")
      (width 40)
      (height 30)
      (tiles
      0 0 0 0 0 0 0 0 0 0 0 0 0 0 0 0 0 0 0 0 0 0 0 0 0 0 0 0 0 0 0 0 0 0 0 0 0 0 0 0
      0 0 0 0 0 0 0 0 0 0 0 0 0 0 0 0 0 0 0 0 0 0 0 0 0 0 0 0 0 0 0 0 0 0 0 0 0 0 0 0
      0 0 0 0 0 0 0 0 0 0 0 0 0 0 0 0 0 0 0 0 0 0 0 0 0 0 0 0 0 0 0 0 0 0 0 0 0 0 0 0
      0 0 0 0 0 0 0 0 0 0 0 0 0 0 0 0 0 0 0 0 0 0 0 0 0 0 0 0 0 0 0 0 0 0 0 0 0 0 0 0
      0 0 0 0 0 0 0 0 0 0 0 2030 2040 2040 2040 2040 2040 2040 2031 0 0 0 0 0 0 0 0 0 0 0 0 0 0 0 0 0 0 0 0 0
      0 0 0 0 0 0 0 0 0 0 0 2041 0 0 0 2039 0 0 2041 0 0 0 0 0 0 0 0 0 0 0 0 0 0 0 0 0 0 0 0 0
      0 0 0 0 0 0 0 0 0 0 0 2041 0 0 0 2044 0 0 2041 0 0 0 0 0 0 0 0 0 0 0 0 0 0 0 0 0 0 0 0 0
      0 0 0 0 0 0 0 0 0 0 0 2041 0 0 0 47 0 0 2034 2040 2040 2031 0 0 0 0 0 0 0 0 0 0 0 0 0 0 0 0 0 0
      0 0 0 0 0 0 0 0 0 0 0 2034 2040 2040 2040 47 0 0 0 0 0 2034 2040 2043 0 0 0 0 0 0 0 0 0 0 0 0 0 0 0 0
      0 0 0 0 0 0 0 0 0 0 0 0 48 40 40 44 40 40 40 40 40 39 0 0 0 0 0 0 0 0 0 0 0 0 0 0 0 0 0 0
      0 0 0 0 0 0 0 0 0 0 0 48 42 0 0 0 0 0 0 0 0 47 0 0 0 0 0 0 0 0 0 0 0 0 0 0 0 0 0 0
      0 0 0 0 0 0 0 0 0 0 0 47 0 0 0 0 0 0 0 0 0 47 0 0 0 0 0 0 0 0 0 0 0 0 0 0 0 0 0 0
      0 0 0 0 0 0 0 0 0 0 0 47 0 0 0 0 0 0 0 0 0 47 0 0 0 0 0 0 0 0 0 0 0 0 0 0 0 0 0 0
      0 0 0 0 0 0 0 0 0 0 0 47 0 0 0 0 0 0 0 0 0 47 0 0 0 0 0 0 0 0 0 0 0 0 0 0 0 0 0 0
      0 0 0 0 0 2030 2031 0 0 0 0 47 0 0 0 0 0 0 0 48 40 42 0 0 0 0 0 0 0 0 0 0 0 0 0 0 0 0 0 0
      0 0 0 0 0 2041 2038 2040 2040 2040 2031 47 0 0 0 48 40 40 40 42 0 0 0 0 0 0 0 0 0 0 0 0 0 0 0 0 0 0 0 0
      0 0 0 0 0 2034 2040 2040 2031 0 2034 37 73 74 75 42 0 0 0 0 0 0 0 0 0 0 0 0 0 0 0 0 0 0 0 0 0 0 0 0
      0 0 0 0 0 0 0 0 2034 2040 2040 2040 2031 0 0 0 0 0 70 0 0 0 0 0 0 0 0 0 0 0 0 0 0 0 0 2041 0 0 0 0
      0 0 0 0 0 0 0 0 0 0 0 0 2034 2031 0 0 0 0 37 40 40 40 39 0 0 0 0 0 0 0 0 0 0 0 0 2041 0 0 0 0
      0 0 0 0 0 0 0 0 2033 0 0 0 0 2041 0 0 0 0 0 0 0 0 9087 0 2038 2040 2040 2040 2040 2040 2040 2040 2040 2040 2040 2035 0 0 0 0
      0 0 0 0 0 0 0 0 0 0 0 0 0 2042 0 0 0 0 2045 0 0 0 9089 0 0 0 0 0 0 0 0 0 0 0 0 0 0 0 0 0
      0 0 0 0 0 0 69 40 40 40 73 74 75 40 40 39 0 0 0 0 48 40 42 0 0 0 0 0 0 0 0 0 0 0 0 0 0 0 0 0
      0 0 0 0 0 0 0 0 0 0 0 0 0 0 0 37 40 40 40 40 42 0 0 0 0 0 0 0 0 0 0 0 0 0 0 0 0 0 0 0
      0 0 0 0 0 0 0 0 0 0 0 0 0 0 0 0 0 0 0 0 0 0 0 0 0 0 0 0 0 0 0 0 0 0 0 0 0 0 0 0
      0 0 0 0 0 0 0 0 0 0 0 0 0 0 0 0 0 0 0 0 0 0 0 0 0 0 0 0 0 0 0 0 0 0 0 0 0 0 0 0
      0 0 0 0 0 0 0 0 0 0 0 0 0 0 0 0 0 0 0 0 0 0 0 0 0 0 0 0 0 0 0 0 0 0 0 0 0 0 0 0
      0 0 0 0 0 0 0 0 0 0 0 0 0 0 0 0 0 0 0 0 0 0 0 0 0 0 0 0 0 0 0 0 0 0 0 0 0 0 0 0
      0 0 0 0 0 0 0 0 0 0 0 0 0 0 0 0 0 0 0 0 0 0 0 0 0 0 0 0 0 0 0 0 0 0 0 0 0 0 0 0
      0 0 0 0 0 0 0 0 0 0 0 0 0 0 0 0 0 0 0 0 0 0 0 0 0 0 0 0 0 0 0 0 0 0 0 0 0 0 0 0
      0 0 0 0 0 0 0 0 0 0 0 0 0 0 0 0 0 0 0 0 0 0 0 0 0 0 0 0 0 0 0 0 0 0 0 0 0 0 0 0
      )
    )
    (tilemap
      (solid #f)
      (z-pos -100)
      (name "background")
      (width 40)
      (height 30)
      (tiles
      9 9 9 9 9 9 9 9 9 9 9 9 9 9 9 9 9 9 9 9 9 9 9 9 9 9 9 9 9 9 9 9 9 9 9 9 9 9 9 9
      9 9 9 9 9 9 9 9 9 9 9 9 9 9 9 9 9 9 9 9 9 9 9 9 9 9 9 9 9 9 9 9 9 9 9 9 9 9 9 9
      9 9 9 9 9 9 9 9 9 9 9 9 9 9 9 9 9 9 9 9 9 9 9 9 9 9 9 9 9 9 9 9 9 9 9 9 9 9 9 9
      9 9 9 9 9 9 9 9 9 9 9 9 9 9 9 9 9 9 9 9 9 9 9 9 9 9 9 9 9 9 9 9 9 9 9 9 9 9 9 9
      9 9 9 9 9 9 9 9 9 9 9 9 9 9 9 9 9 9 9 9 9 9 9 9 9 9 9 9 9 9 9 9 9 9 9 9 9 9 9 9
      9 9 9 9 9 9 9 9 9 9 9 9 9 9 9 9 9 9 9 9 9 9 9 9 9 9 9 9 9 9 9 9 9 9 9 9 9 9 9 9
      9 9 9 9 9 9 9 9 9 9 9 9 9 9 19 0 9 9 19 9 9 9 9 9 9 9 9 9 9 9 9 9 9 9 9 9 9 9 9 9
      9 9 9 9 9 9 9 9 9 9 9 9 9 9 9 19 9 9 9 9 9 9 9 9 9 9 9 9 9 9 9 9 9 9 9 9 9 9 9 9
      9 9 9 9 9 9 9 9 9 9 9 9 9 9 9 19 9 9 9 9 9 9 9 9 9 9 9 9 9 9 9 9 9 9 9 9 9 9 9 9
      9 9 9 9 9 9 9 9 9 9 9 9 9 19 19 19 19 9 9 19 19 9 9 9 9 9 9 9 9 9 9 9 9 9 9 9 9 9 9 9
      9 9 9 9 9 9 9 9 9 9 9 19 19 19 19 19 19 19 19 19 9 9 9 9 9 9 9 9 9 9 9 9 9 9 9 9 9 9 9 9
      9 9 9 9 9 9 9 9 9 9 9 19 19 19 19 19 19 19 19 19 9 9 9 9 9 9 9 9 9 9 9 9 9 9 9 9 9 9 9 9
      9 9 9 9 9 9 9 9 9 9 19 19 19 19 19 19 19 19 19 9 9 9 9 9 9 9 9 9 9 9 9 9 9 9 9 9 9 9 9 9
      9 9 9 9 9 9 9 9 9 9 9 19 19 19 19 19 19 19 19 9 9 9 9 9 9 9 9 9 9 9 9 9 9 9 9 9 9 9 9 9
      9 9 9 9 9 9 9 9 9 9 9 19 19 19 19 19 19 19 19 19 9 9 9 9 9 9 9 9 9 9 9 9 9 9 9 9 9 9 9 9
      9 9 9 9 9 9 19 19 19 19 19 19 9 9 9 19 19 19 19 19 9 9 9 9 9 9 9 9 9 9 9 9 9 9 9 9 9 9 9 9
      9 9 9 9 9 19 19 19 19 19 19 19 9 9 9 19 9 9 9 9 9 9 9 9 9 9 9 9 9 9 9 9 9 9 9 9 9 9 9 9
      9 9 9 9 9 9 9 9 9 9 9 9 9 9 9 9 9 9 9 9 9 19 19 19 19 9 9 9 9 9 9 9 9 9 9 9 9 9 9 9
      9 9 9 9 9 9 9 9 9 9 9 9 9 9 9 9 9 9 19 19 19 19 19 19 9 9 9 9 9 9 9 9 9 9 9 9 9 9 9 9
      9 9 9 9 9 9 9 9 9 9 9 9 9 9 9 9 9 9 9 9 9 9 9 9 9 9 9 9 9 9 9 9 9 9 9 9 9 9 9 9
      9 9 9 9 9 9 9 19 19 19 9 9 9 19 19 9 9 9 9 9 9 9 9 9 9 9 9 9 9 9 9 9 9 9 9 9 9 9 9 9
      9 9 9 9 9 9 9 19 19 19 9 9 9 19 19 19 19 19 19 9 9 19 19 9 9 9 9 9 9 9 9 9 9 9 9 9 9 9 9 9
      9 9 9 9 9 9 9 9 9 9 9 9 9 19 19 19 19 19 19 19 19 9 9 9 9 9 9 9 9 9 9 9 9 9 9 9 9 9 9 9
      9 9 9 9 9 9 9 9 9 9 9 9 9 9 9 9 9 19 9 9 9 9 9 9 9 9 9 9 9 9 9 9 9 9 9 9 9 9 9 9
      9 9 9 9 9 9 9 9 9 9 9 9 9 9 9 9 9 9 9 9 9 9 9 9 9 9 9 9 9 9 9 9 9 9 9 9 9 9 9 9
      9 9 9 9 9 9 9 9 9 9 9 9 9 9 9 9 9 9 9 9 9 9 9 9 9 9 9 9 9 9 9 9 9 9 9 9 9 9 9 9
      9 9 9 9 9 9 9 9 9 9 9 9 9 9 9 9 9 9 9 9 9 9 9 9 9 9 9 9 9 9 9 9 9 9 9 9 9 9 9 9
      9 9 9 9 9 9 9 9 9 9 9 9 9 9 9 9 9 9 9 9 9 9 9 9 9 9 9 9 9 9 9 9 9 9 9 9 9 9 9 9
      9 9 9 9 9 9 9 9 9 9 9 9 9 9 9 9 9 9 9 9 9 9 9 9 9 9 9 9 9 9 9 9 9 9 9 9 9 9 9 9
      9 9 9 9 9 9 9 9 9 9 9 9 9 9 9 9 9 9 9 9 9 9 9 9 9 9 9 9 9 9 9 9 9 9 9 9 9 9 9 9
      )
    )
    (tilemap
      (solid #f)
      (z-pos -10)
      (name "backdetail")
      (width 40)
      (height 30)
      (tiles
      0 0 0 0 0 0 0 0 0 0 0 0 0 0 0 0 0 0 0 0 0 0 0 0 0 0 0 0 0 0 0 0 0 0 0 0 0 0 0 0
      0 0 0 0 0 0 0 0 0 0 0 0 0 0 0 0 0 0 0 0 0 0 0 0 0 0 0 0 0 0 0 0 0 0 0 0 0 0 0 0
      0 0 0 0 0 0 0 0 0 0 0 0 0 0 0 0 0 0 0 0 0 0 0 0 0 0 0 0 0 0 0 0 0 0 0 0 0 0 0 0
      0 0 0 0 0 0 0 0 0 0 0 0 0 0 0 0 0 0 11 12 0 0 0 0 0 0 0 0 0 0 0 0 0 0 0 0 0 0 0 0
      0 0 0 0 0 0 0 0 0 0 11 16 12 0 11 16 12 0 14 13 0 0 0 0 0 0 0 0 0 0 0 0 0 0 0 0 0 0 0 0
      0 0 0 0 0 0 0 0 0 0 15 20 13 11 22 58 17 11 16 16 12 0 0 0 0 0 0 0 0 0 0 0 0 0 0 0 0 0 0 0
      0 0 0 0 0 0 0 0 0 0 14 13 11 22 0 59 17 15 0 20 13 0 0 0 0 0 0 0 0 0 0 0 0 0 0 0 0 0 0 0
      0 0 0 0 0 0 0 0 0 11 12 0 14 18 21 0 17 14 18 13 0 11 16 16 12 0 0 0 0 0 0 0 0 0 0 0 0 0 0 0
      0 0 0 0 0 0 0 0 0 14 13 0 11 16 22 0 23 12 11 16 16 22 20 18 13 0 0 0 0 0 0 0 0 0 0 0 0 0 0 0
      0 0 0 0 0 0 0 0 0 0 11 16 22 0 0 0 0 23 22 0 0 20 13 0 0 0 0 0 0 0 0 0 0 0 0 0 0 0 0 0
      0 0 0 0 0 0 0 0 0 0 15 0 0 0 24 25 2172 2183 0 0 20 13 0 0 0 0 0 0 0 0 0 0 0 0 0 0 0 0 0 0
      0 0 0 0 0 11 12 0 0 11 22 0 0 0 31 32 0 0 0 0 17 0 0 0 0 0 0 0 0 0 0 0 0 0 0 0 0 0 0 0
      0 0 0 0 0 15 23 12 0 15 0 0 0 24 33 35 0 0 0 20 13 0 0 0 0 0 0 0 0 0 0 0 0 0 0 0 0 0 0 0
      0 0 0 0 0 14 21 17 0 14 21 0 0 30 36 34 0 0 0 23 12 0 0 0 0 0 0 0 0 0 0 0 0 0 794 795 0 0 0 0
      0 0 0 0 0 11 22 23 16 16 22 0 0 0 30 29 29 29 28 0 17 0 0 0 0 0 0 0 0 0 0 0 0 0 792 793 0 0 0 0
      0 0 0 0 11 22 0 0 24 26 0 0 20 18 21 0 0 0 0 0 17 0 0 0 0 0 0 0 0 0 0 0 0 0 0 0 0 0 0 0
      0 0 0 0 15 0 0 0 30 28 0 0 17 0 15 0 20 18 18 18 13 16 16 16 16 12 0 0 0 0 0 0 0 0 0 0 0 0 0 0
      0 0 0 0 15 20 18 18 18 18 18 18 13 0 14 18 13 11 16 16 22 53 54 30 29 17 0 0 0 0 0 0 0 0 0 0 0 0 0 0
      0 0 0 11 22 17 0 0 11 12 0 0 0 0 11 12 0 15 0 0 55 56 57 0 20 13 0 0 0 0 0 0 0 0 0 0 0 0 0 0
      0 0 0 15 20 13 11 16 22 23 12 0 11 16 22 17 0 14 18 18 18 18 18 18 13 0 0 0 0 0 0 0 0 0 0 0 0 0 0 0
      0 0 0 14 13 0 15 52 53 54 17 0 15 30 28 23 16 16 16 12 11 16 16 12 0 0 0 0 0 0 0 0 0 0 0 0 0 0 0 0
      0 0 0 15 17 11 22 55 56 57 17 0 15 0 0 0 0 52 54 23 22 0 0 17 0 0 0 0 0 0 0 0 0 0 0 0 0 0 0 0
      0 0 0 15 17 14 18 18 21 20 13 0 15 0 0 0 0 55 57 0 0 20 18 13 0 0 0 0 0 0 0 0 0 0 0 0 0 0 0 0
      0 0 0 15 17 0 0 0 14 13 0 0 15 20 18 18 21 0 20 18 18 13 0 0 0 0 0 0 0 0 0 0 0 0 0 0 0 0 0 0
      0 0 0 14 13 16 16 12 11 16 12 16 22 17 0 0 14 18 13 0 0 0 0 0 0 0 0 0 0 0 0 0 0 0 0 0 0 0 0 0
      0 0 0 0 14 18 18 13 14 18 13 18 18 13 0 0 0 0 0 0 0 0 0 0 0 0 0 0 0 0 0 0 0 0 0 0 0 0 0 0
      0 0 0 0 0 0 0 0 0 0 0 0 0 0 0 0 0 0 0 0 0 0 0 0 0 11 12 0 0 0 0 0 0 0 0 0 0 0 0 0
      0 0 0 0 0 0 0 0 0 0 0 0 0 0 0 0 0 0 0 0 0 0 0 0 0 14 13 0 0 0 0 0 0 0 0 0 0 0 0 0
      0 0 0 0 0 0 0 0 0 0 0 0 0 0 0 0 0 0 0 0 0 0 0 0 0 0 0 0 0 0 0 0 0 0 0 0 0 0 0 0
      0 0 0 0 0 0 0 0 0 0 0 0 0 0 0 0 0 0 0 0 0 0 0 0 0 0 0 0 0 0 0 0 0 0 0 0 0 0 0 0
      )
    )
    (tilemap
      (solid #f)
      (z-pos 100)
      (name "foredetail")
      (width 40)
      (height 30)
      (tiles
      0 0 0 0 0 0 0 0 0 0 0 0 0 0 0 0 0 0 0 0 0 0 0 0 0 0 0 0 0 0 0 0 0 0 0 0 0 0 0 0
      0 0 0 0 0 0 0 0 0 0 0 0 0 0 0 0 0 0 0 0 0 0 0 0 0 0 0 0 0 0 0 0 0 0 0 0 0 0 0 0
      0 0 0 0 0 0 0 0 0 0 0 0 0 0 0 0 0 0 0 0 0 0 0 0 0 0 0 0 0 0 0 0 0 0 0 0 0 0 0 0
      0 0 0 0 0 0 0 0 0 0 0 0 0 0 0 0 0 0 0 0 0 0 0 0 0 0 0 0 0 0 0 0 0 0 0 0 0 0 0 0
      0 0 0 0 0 0 0 0 0 0 0 0 0 0 0 0 0 0 0 0 0 0 0 0 0 0 0 0 0 0 0 0 0 0 0 0 0 0 0 0
      0 0 0 0 0 0 0 0 0 0 0 0 0 0 0 0 0 0 2171 2179 0 0 0 0 0 0 0 0 0 0 0 0 0 0 0 0 0 0 0 0
      0 0 0 0 0 0 0 0 0 0 0 0 0 0 0 0 0 0 2172 2180 0 0 0 0 0 0 0 0 0 0 0 0 0 0 0 0 0 0 0 0
      0 0 0 0 0 0 0 0 0 0 0 0 0 0 0 0 0 0 0 0 0 0 0 0 0 0 0 0 0 0 0 0 0 0 0 0 0 0 0 0
      0 0 0 0 0 0 0 0 0 0 0 0 0 0 0 0 0 0 0 0 0 0 0 0 0 0 0 0 0 0 0 0 0 0 0 0 0 0 0 0
      0 0 0 0 0 0 0 0 0 0 0 0 0 0 0 0 2171 2173 2175 2177 2179 0 0 0 0 0 0 0 0 0 0 0 0 0 0 0 0 0 0 0
      0 0 0 0 0 0 0 0 0 0 0 0 0 0 0 0 25 26 2176 2178 2180 0 0 0 0 0 0 0 0 0 0 0 0 0 0 0 0 0 0 0
      0 0 0 0 0 0 0 0 0 0 0 0 0 0 0 0 35 28 0 0 0 0 0 0 0 0 0 0 0 0 0 0 0 0 0 0 0 0 0 0
      0 0 0 0 0 0 0 0 0 0 0 0 0 0 0 0 28 0 0 0 0 0 0 0 0 0 0 0 0 0 0 0 0 0 0 0 0 0 0 0
      0 0 0 0 0 0 0 0 0 0 0 0 0 0 0 0 25 25 26 0 0 0 0 0 0 0 0 0 0 0 0 0 0 0 0 0 0 0 0 0
      0 0 0 0 0 0 0 0 0 0 0 0 0 0 0 0 0 0 0 0 0 0 0 0 0 0 0 0 0 0 0 0 0 0 0 0 0 0 0 0
      0 0 0 0 0 0 0 0 0 0 0 0 0 0 0 0 0 0 0 0 0 0 0 0 0 0 0 0 0 0 0 0 0 0 0 0 0 0 0 0
      0 0 0 0 0 0 0 0 0 0 0 0 0 0 0 0 0 0 0 0 49 50 51 24 25 26 0 0 0 0 0 0 0 0 0 0 0 0 0 0
      0 0 0 0 0 0 0 0 0 0 11 12 0 0 0 0 0 0 0 0 0 0 0 0 0 28 0 0 0 0 0 0 0 0 0 0 0 0 0 0
      0 0 0 0 0 0 0 0 0 0 14 13 0 0 0 0 0 0 0 0 0 0 0 0 0 0 0 0 0 0 0 0 0 0 0 0 0 0 0 0
      0 0 0 0 0 0 0 49 50 51 0 0 0 24 26 0 0 0 0 0 0 0 0 0 0 0 0 0 0 0 0 0 0 0 0 0 0 0 0 0
      0 0 0 11 12 0 0 0 0 0 0 0 0 0 0 0 0 49 51 0 0 0 0 0 0 0 0 0 0 0 0 0 0 0 0 0 0 0 0 0
      0 0 0 0 0 0 0 0 0 0 0 0 0 2171 2179 0 0 0 0 0 0 0 0 0 0 0 0 0 0 0 0 0 0 0 0 0 0 0 0 0
      0 0 0 0 0 0 0 0 0 0 0 0 0 2172 2180 0 0 49 51 0 0 0 0 0 0 0 0 0 0 0 0 0 0 0 0 0 0 0 0 0
      0 0 0 0 0 0 0 0 0 0 0 0 0 0 0 0 0 52 54 0 0 0 0 0 0 0 0 0 0 0 0 0 0 0 0 0 0 0 0 0
      0 0 0 0 11 0 0 0 0 0 11 0 0 0 0 0 0 55 57 0 0 0 0 0 0 0 0 0 0 0 0 0 0 0 0 0 0 0 0 0
      0 0 0 0 0 0 0 11 12 0 14 0 0 0 0 0 0 0 0 0 0 0 0 0 0 0 0 0 0 0 0 0 0 0 0 0 0 0 0 0
      0 0 0 0 0 0 0 14 13 0 0 0 0 0 0 0 0 0 0 0 0 0 0 0 0 0 0 0 0 0 0 0 0 0 0 0 0 0 0 0
      0 0 0 0 0 0 0 0 0 0 0 0 0 0 0 0 0 0 0 0 0 0 0 0 0 0 0 0 0 0 0 0 0 0 0 0 0 0 0 0
      0 0 0 0 0 0 0 0 0 0 0 0 0 0 0 0 0 0 0 0 0 0 0 0 0 0 0 0 0 0 0 0 0 0 0 0 0 0 0 0
      0 0 0 0 0 0 0 0 0 0 0 0 0 0 0 0 0 0 0 0 0 0 0 0 0 0 0 0 0 0 0 0 0 0 0 0 0 0 0 0
      )
    )
    (tilemap
      (solid #f)
      (z-pos -5)
      (name "thinice")
      (width 40)
      (height 30)
      (tiles
      0 0 0 0 0 0 0 0 0 0 0 0 0 0 0 0 0 0 0 0 0 0 0 0 0 0 0 0 0 0 0 0 0 0 0 0 0 0 0 0
      0 0 0 0 0 0 0 0 0 0 0 0 0 0 0 0 0 0 0 0 0 0 0 0 0 0 0 0 0 0 0 0 0 0 0 0 0 0 0 0
      0 0 0 0 0 0 0 0 0 0 0 0 0 0 0 0 0 0 0 0 0 0 0 0 0 0 0 0 0 0 0 0 0 0 0 0 0 0 0 0
      0 0 0 0 0 0 0 0 0 0 0 0 0 0 0 0 0 0 0 0 0 0 0 0 0 0 0 0 0 0 0 0 0 0 0 0 0 0 0 0
      0 0 0 0 0 0 0 0 0 0 0 0 0 0 0 0 0 0 0 0 0 0 0 0 0 0 0 0 0 0 0 0 0 0 0 0 0 0 0 0
      0 0 0 0 0 0 0 0 0 0 0 0 0 0 0 0 0 0 0 0 0 0 0 0 0 0 0 0 0 0 0 0 0 0 0 0 0 0 0 0
      0 0 0 0 0 0 0 0 0 0 0 0 0 0 0 0 0 0 0 0 0 0 0 0 0 0 0 0 0 0 0 0 0 0 0 0 0 0 0 0
      0 0 0 0 0 0 0 0 0 0 0 0 0 0 0 0 0 0 0 0 0 0 2204 2206 0 0 0 0 0 0 0 0 0 0 0 0 0 0 0 0
      0 0 0 0 0 0 0 0 0 0 0 0 0 0 0 0 0 0 0 0 0 2204 2216 2215 2206 0 2218 0 0 0 0 0 0 0 0 0 0 0 0 0
      0 0 0 0 0 0 0 0 0 0 0 0 0 0 0 0 0 0 0 2204 2205 2216 2208 2208 2209 0 0 0 0 0 0 0 0 0 0 0 0 0 0 0
      0 0 0 0 0 0 0 0 0 0 0 0 0 0 0 0 0 0 0 2207 2208 2208 2208 2217 2215 2206 0 0 0 0 0 0 0 0 0 0 0 0 0 0
      0 0 0 0 0 0 0 0 0 0 0 0 0 0 0 0 2204 2206 2204 2216 2208 2208 2208 2208 2208 2215 2205 2206 0 2218 0 0 0 0 0 0 0 0 0 0
      0 0 0 0 0 0 0 0 0 0 0 0 0 0 0 0 2207 2215 2216 2208 2208 2208 2208 2208 2213 2214 2208 2209 0 0 0 0 0 0 0 0 0 0 0 0
      0 0 0 0 0 0 0 0 0 0 0 0 0 0 0 0 2210 2211 2211 2214 2208 2208 2208 2208 2215 2216 2208 2215 2206 0 0 0 0 0 0 0 0 0 0 0
      0 0 0 0 0 0 0 0 0 0 0 0 0 0 0 0 0 0 0 2207 2208 2208 2217 2213 2211 2214 2213 2211 2212 0 0 0 0 0 0 0 0 0 0 0
      0 0 0 0 0 0 0 0 0 0 0 0 0 0 0 0 0 0 0 2210 2211 2214 2208 2209 0 2210 2212 0 2204 2206 0 0 0 0 0 0 0 0 0 0
      0 0 0 0 0 0 0 0 0 0 0 0 0 0 0 2204 2205 2206 0 0 11 2210 2211 2212 0 0 0 0 2210 2212 0 0 0 0 0 0 0 0 0 0
      0 0 0 0 0 0 0 0 0 0 0 0 0 0 0 2207 2208 2209 0 0 52 0 0 0 0 0 0 0 0 0 0 0 0 0 0 0 0 0 0 0
      0 0 0 0 0 0 0 0 0 0 0 0 0 0 0 2207 2217 2209 0 0 0 0 0 0 0 0 0 0 0 0 0 0 0 0 0 0 0 0 0 0
      0 0 0 0 0 0 0 0 0 0 0 0 0 0 2204 2216 2208 2215 2206 0 0 0 0 0 0 0 0 0 0 0 0 0 0 0 0 0 0 0 0 0
      0 0 0 0 0 0 0 0 0 0 0 0 0 0 2210 2214 2213 2211 2212 0 0 0 0 0 0 0 0 0 0 0 0 0 0 0 0 0 0 0 0 0
      0 0 0 0 0 0 0 0 0 0 0 0 0 0 0 2210 2212 0 0 0 0 0 0 0 0 0 0 0 0 0 0 0 0 0 0 0 0 0 0 0
      0 0 0 0 0 0 0 0 0 0 0 0 0 0 0 0 0 0 0 0 0 0 0 11 12 0 0 0 0 0 0 0 0 0 0 0 0 0 0 0
      0 0 0 0 0 0 0 0 0 0 0 0 0 0 0 0 0 0 0 0 0 0 0 14 13 0 0 0 0 0 0 0 0 0 0 0 0 0 0 0
      0 0 0 0 0 0 0 0 0 0 0 0 0 0 0 0 0 0 0 0 0 0 0 0 0 0 0 0 0 0 0 0 0 0 0 0 0 0 0 0
      0 0 0 0 0 0 0 0 0 0 0 0 0 0 0 0 0 0 0 0 0 0 0 0 0 0 0 0 0 0 0 0 0 0 0 0 0 0 0 0
      0 0 0 0 0 0 0 0 0 0 0 0 0 0 0 0 0 0 0 0 0 0 0 0 0 0 0 0 0 0 0 0 0 0 0 0 0 0 0 0
      0 0 0 0 0 0 0 0 0 0 0 0 0 0 0 0 0 0 0 0 0 0 0 0 0 0 0 0 0 0 0 0 0 0 0 0 0 0 0 0
      0 0 0 0 0 0 0 0 0 0 0 0 0 0 0 0 0 0 0 0 0 0 0 0 0 0 0 0 0 0 0 0 0 0 0 0 0 0 0 0
      0 0 0 0 0 0 0 0 0 0 0 0 0 0 0 0 0 0 0 0 0 0 0 0 0 0 0 0 0 0 0 0 0 0 0 0 0 0 0 0
      )
    )
    (level
      (name "mattie_iceberg/Trophy.stl")
      (sprite "images/objects/invisible/invisible.sprite")
      (x 20)
      (y 13)
    )
    (level
      (name "mattie_iceberg/D_DOOM.stl")
      (x 15)
      (y 8)
    )
    (level
      (name "mattie_iceberg/D_Fields.stl")
      (x 15)
      (y 9)
    )
    (level
      (name "mattie_iceberg/D_Quarry.stl")
      (x 13)
      (y 9)
    )
    (level
      (name "mattie_iceberg/D_Mineshaft.stl")
      (x 11)
      (y 12)
    )
    (level
      (name "mattie_iceberg/D_Dungeon.stl")
      (x 11)
      (y 16)
    )
    (level
      (name "mattie_iceberg/D_Cavern.stl")
      (x 18)
      (y 15)
    )
    (level
      (name "mattie_iceberg/D_HighRoute.stl")
      (x 19)
      (y 9)
    )
    (level
      (name "mattie_iceberg/D_ScarySkies.stl")
      (x 21)
      (y 11)
    )
    (level
      (name "mattie_iceberg/D_ThreeLanterns.stl")
      (x 21)
      (y 21)
    )
    (level
      (name "mattie_iceberg/D_Wall.stl")
      (x 18)
      (y 22)
    )
    (level
      (name "mattie_iceberg/D_MtnPass.stl")
      (x 14)
      (y 21)
    )
    (level
      (name "mattie_iceberg/D_Moat.stl")
      (x 11)
      (y 21)
    )
    (level
      (name "mattie_iceberg/D_Escape.stl")
      (extro-script "  wait_for_screenswitch();
        display_text_file(  \"levels/mattie_world/mattie_iceberg/iceberg_end.txt\"  );  ")
      (x 7)
      (y 21)
    )
    (level
      (name "TimeWarp.stl")
      (sprite "images/worldmap/common/hiddendot.sprite")
      (x 15)
      (y 5)
    )
    (worldmap-spawnpoint
      (name "main")
      (x 15)
      (y 6)
    )
    (worldmap-spawnpoint
      (name "islands")
      (x 6)
      (y 21)
    )
  )
  (tileset "images/LMH_iceberg_worldmap.strf")
)
