;; Created by RoofRabbit ST_Editor
(supertux-level
  (sector
    (name "Tux Strikes Back")
    (music "music/salcon.ogg")
  (worldmap-spawnpoint
    (name "main")
    (x 8)
    (y 4)
  )
  (tilemap
    (width  32)
    (height 30)
    (solid #t)
    (tiles
       63 63 63 63 63 63 63 63 63 63 63 63 63 63 63 63 63 63 63 11 16 16 16 16 12 63 63 63 63 63 63 63 
       63 63 63 63 63 63 63 63 63 63 63 63 63 63 63 63 63 63 63 15 67 49 50 51 23 16 12 63 63 63 63 63 
       63 63 63 63 63 11 16 16 16 16 16 16 12 63 63 63 63 63 63 15 67 52 53 54 60 19 23 16 16 16 12 63 
       63 63 63 63 63 62 19 19 58 19 19 19 17 63 63 63 63 63 63 15 67 55 56 57 39 19 19 24 25 26 17 63 
       63 11 16 12 63 62 19 19 59 19 60 19 23 12 63 63 63 63 63 15 19 48 40 40 42 67 67 30 29 28 64 63 
       63 15 60 17 63 62 60 19 47 19 24 25 26 23 16 16 16 12 63 15 19 37 40 40 40 40 40 40 39 67 64 63 
       63 15 19 17 63 62 19 19 47 19 30 29 28 19 19 19 60 17 63 15 19 60 19 67 67 60 67 67 47 67 64 63 
       63 14 18 13 63 62 19 19 47 48 40 40 40 40 40 39 19 17 63 14 18 18 18 18 21 67 48 40 42 67 64 63 
       63 63 63 63 63 62 19 19 47 47 19 19 19 19 19 47 19 23 16 16 16 16 16 12 62 67 47 67 60 67 64 63 
       63 63 63 63 63 62 19 60 47 47 19 60 20 18 21 47 19 19 19 67 60 67 19 17 62 67 37 40 39 67 64 63 
       63 63 63 63 63 62 19 19 37 42 19 19 17 63 62 37 40 40 40 39 67 67 67 17 62 24 25 26 47 67 64 63 
       63 63 63 63 63 62 19 19 19 19 60 19 17 63 62 19 60 19 19 47 67 19 60 17 62 30 29 28 47 67 64 63 
       63 63 63 63 63 14 18 18 18 18 18 18 13 63 14 18 18 21 19 47 19 20 18 13 62 67 67 67 47 60 64 63 
       63 63 63 63 63 63 63 63 63 63 63 63 63 63 63 63 63 15 19 47 60 17 63 63 15 48 40 40 42 67 64 63 
       63 63 63 63 63 63 63 63 63 63 63 63 63 63 63 63 63 15 19 47 67 23 16 16 22 47 67 60 67 67 64 63 
       63 63 63 63 63 63 63 63 63 63 63 63 63 63 63 63 63 15 60 47 67 67 67 60 67 37 40 39 67 20 13 63 
       63 63 63 63 63 63 63 63 63 63 63 63 63 63 63 63 63 15 19 37 40 40 40 40 40 40 40 42 67 64 63 63 
       63 63 63 63 63 63 63 63 63 63 63 63 63 63 63 63 63 15 24 25 26 67 60 67 67 67 67 67 60 64 63 63 
       63 63 63 63 63 63 63 63 63 63 63 63 63 63 63 63 63 15 30 29 28 20 18 18 18 18 18 18 18 13 63 63 
       63 63 63 63 63 63 63 63 63 63 63 63 63 63 63 63 63 14 18 18 18 13 63 63 63 63 63 63 63 63 63 63 
       63 63 63 63 63 63 63 63 63 63 63 63 63 63 63 63 63 63 63 63 63 63 63 63 63 63 63 63 63 63 63 63 
       63 63 63 63 63 63 63 63 63 63 63 63 63 63 63 63 63 63 63 63 63 63 63 63 63 63 63 63 63 63 63 63 
       63 63 63 63 63 11 16 12 63 63 63 63 63 63 63 63 63 63 63 63 63 63 63 63 63 63 63 63 63 63 63 63 
       63 63 63 63 63 15 70 17 63 63 63 63 63 63 63 63 63 63 63 63 63 63 63 63 63 63 63 63 63 63 63 63 
       63 63 63 63 63 15 47 17 63 63 63 63 63 63 63 63 63 63 63 63 63 63 63 63 63 63 63 63 63 63 63 63 
       63 63 63 63 63 15 65 17 63 63 63 63 63 63 63 63 63 63 63 63 63 63 63 63 63 63 63 63 63 63 63 63 
       63 63 63 63 63 15 68 17 63 63 63 63 63 63 63 63 63 63 63 63 63 63 63 63 63 63 63 63 63 63 63 63 
       63 63 63 63 63 14 18 13 63 63 63 63 63 63 63 63 63 63 63 63 63 63 63 63 63 63 63 63 63 63 63 63 
       63 63 63 63 63 63 63 63 63 63 63 63 63 63 63 63 63 63 63 63 63 63 63 63 63 63 63 63 63 63 63 63 
       63 63 63 63 63 63 63 63 63 63 63 63 63 63 63 63 63 63 63 63 63 63 63 63 63 63 63 63 63 63 63 63 
       ))
     (level (name "tsb-level00.stl")
           (sprite "images/objects/invisible/invisible.sprite")
		   (auto-play #t)
           (x  8)
           (y  4))
     (level (name "tsb-level01.stl")
           (x  8)
           (y  7))
     (level (name "tsb-level02.stl")
           (x  9)
           (y  10))
     (level (name "tsb-level03.stl")
           (x  10)
           (y  7))
     (level (name "tsb-level04.stl")
           (x  14)
           (y  7))
     (level (name "tsb-level05.stl")
           (x  15)
           (y  10))
     (level (name "tsb-level06.stl")
           (x  19)
           (y  10))
     (level (name "tsb-level07.stl")
           (x  19)
           (y  14))
     (level (name "tsb-level08.stl")
           (x  21)
           (y  16))
     (level (name "tsb-level09.stl")
           (x  25)
           (y  16))
     (level (name "tsb-level10.stl")
           (x  26)
           (y  15))
     (level (name "tsb-level11.stl")
           (x  26)
           (y  13))
     (level (name "tsb-level12.stl")
           (x  28)
           (y  11))
     (level (name "tsb-level13.stl")
           (x  26)
           (y  9))
     (level (name "tsb-level14.stl")
           (x  28)
           (y  7))
     (level (name "tsb-level15.stl")
           (x  26)
           (y  5))
     (level (name "tsb-level16.stl")
           (x  22)
           (y  5))
     (level (name "tsb-level17.stl")
           (x  23)
           (y  4))
     (level (name "tsb-level18.stl")
           (x  22)
           (y  3)
	   (extro-script "
wait_for_screenswitch(); //because it needs to exit the game screen
display_text_file(\"levels/tsb/extro-tsb.txt\");
"))
     (teleporter
           (x 28)
           (y 13)
           (spawnpoint "x6y24"))
     (worldmap-spawnpoint
       (x 6)
       (y 24)
       (name "x6y24")
     )
     (teleporter
           (x 6)
           (y 26)
      (sprite "images/worldmap/common/teleporterdot.sprite")
           (message "I wonder where I will go next...")
           (spawnpoint "x28y13"))
     (worldmap-spawnpoint
       (x 28)
       (y 13)
       (name "x28y13")
     )
     (level (name "tsb-level19.stl")
           (x  6)
           (y  25))
     (teleporter
           (x 6)
           (y 23)
           (message "I hope this thing still works...")
           (sprite "images/worldmap/common/teleporterdot.sprite")
           (spawnpoint "x28y13"))
      ))
