(supertux-level
  (version 2)
  (name (_ ""))
  (author "")
  (license "CC BY-SA 4.0+")
  (target-time 0)
  (sector
    (name "Tux Strikes Back")
    (music "music/salcon.ogg")
    (ambient-light 1 1 1)
    (teleporter
      (spawnpoint "x6y24")
      (x 35)
      (y 23)
    )
    (teleporter
      (spawnpoint "x28y13")
      (message (_ "I wonder where I will go next..."))
      (sprite "images/worldmap/common/teleporterdot.sprite")
      (x 13)
      (y 36)
    )
    (teleporter
      (spawnpoint "x28y13")
      (message (_ "I hope this thing still works..."))
      (sprite "images/worldmap/common/teleporterdot.sprite")
      (x 13)
      (y 33)
    )
    (tilemap
      (solid #t)
      (z-pos 0)
      (width 48)
      (height 48)
      (tiles
      9 9 9 9 9 9 9 9 9 9 9 9 9 9 9 9 9 9 9 9 9 9 9 9 9 9 9 9 9 9 9 9 9 9 9 9 9 9 9 9 9 9 9 9 9 9 9 9
      9 9 9 9 9 9 9 9 9 9 9 9 9 9 9 9 9 9 9 9 9 9 9 9 9 9 9 9 9 9 9 9 9 9 9 9 9 9 9 9 9 9 9 9 9 9 9 9
      9 9 9 9 9 9 9 9 9 9 9 9 9 9 9 9 9 9 9 9 9 9 9 9 9 9 9 9 9 9 9 9 9 9 9 9 9 9 9 9 9 9 9 9 9 9 9 9
      9 9 9 9 9 9 9 9 9 9 9 9 9 9 9 9 9 9 9 9 9 9 9 9 9 9 9 9 9 9 9 9 9 9 9 9 9 9 9 9 9 9 9 9 9 9 9 9
      9 9 9 9 9 9 9 9 9 9 9 9 9 9 9 9 9 9 9 9 9 9 9 9 9 9 9 9 9 9 9 9 9 9 9 9 9 9 9 9 9 9 9 9 9 9 9 9
      9 9 9 9 9 9 9 9 9 9 9 9 9 9 9 9 9 9 9 9 9 9 9 9 9 9 9 9 9 9 9 9 9 9 9 9 9 9 9 9 9 9 9 9 9 9 9 9
      9 9 9 9 9 9 9 9 9 9 9 9 9 9 9 9 9 9 9 9 9 9 9 9 9 9 9 9 9 9 9 9 9 9 9 9 9 9 9 9 9 9 9 9 9 9 9 9
      9 9 9 9 9 9 9 9 9 9 9 9 9 9 9 9 9 9 9 9 9 9 9 9 9 9 9 9 9 9 9 9 9 9 9 9 9 9 9 9 9 9 9 9 9 9 9 9
      9 9 9 9 9 9 9 9 9 9 9 9 9 9 9 9 9 9 9 9 9 9 9 9 9 9 9 9 9 9 9 9 9 9 9 9 9 9 9 9 9 9 9 9 9 9 9 9
      9 9 9 9 9 9 9 9 9 9 9 9 9 9 9 9 9 9 9 9 9 9 9 9 9 9 9 9 9 9 9 9 9 9 9 9 9 9 9 9 9 9 9 9 9 9 9 9
      9 9 9 9 9 9 9 9 9 9 9 9 9 9 9 9 9 9 9 9 9 9 9 9 9 9 11 16 16 16 16 12 9 9 9 9 9 9 9 9 9 9 9 9 9 9 9 9
      9 9 9 9 9 9 9 9 9 9 9 9 9 9 9 9 9 9 9 9 9 9 9 9 9 9 15 19 49 50 51 23 16 12 9 9 9 9 9 9 9 9 9 9 9 9 9 9
      9 9 9 9 9 9 9 9 9 9 9 9 11 16 16 16 16 16 16 12 9 9 9 9 9 9 15 19 52 53 54 60 19 23 16 16 16 12 9 9 9 9 9 9 9 9 9 9
      9 9 9 9 9 9 9 9 9 9 9 9 15 19 19 58 19 19 19 17 9 9 9 9 9 9 15 19 55 56 57 39 19 19 24 25 26 17 9 9 9 9 9 9 9 9 9 9
      9 9 9 9 9 9 9 9 11 16 16 16 22 19 19 59 19 60 19 23 12 9 9 9 9 9 15 19 48 40 40 42 19 19 30 29 28 17 9 9 9 9 9 9 9 9 9 9
      9 9 9 9 9 9 9 9 15 24 25 26 19 60 19 47 19 24 25 26 23 16 16 16 12 9 15 19 37 40 40 40 40 40 40 39 19 17 9 9 9 9 9 9 9 9 9 9
      9 9 9 9 9 9 9 9 15 30 29 28 19 19 19 47 19 30 29 28 19 19 19 60 17 9 15 19 60 19 19 19 60 19 19 47 19 17 9 9 9 9 9 9 9 9 9 9
      9 9 9 9 9 9 9 9 14 18 18 18 21 19 19 47 48 40 40 40 40 40 39 19 17 9 14 18 18 18 18 21 19 48 40 42 19 17 9 9 9 9 9 9 9 9 9 9
      9 9 9 9 9 9 9 9 9 9 9 9 15 19 19 47 47 19 19 19 19 19 47 19 23 16 16 16 16 16 12 15 19 47 19 60 19 17 9 9 9 9 9 9 9 9 9 9
      9 9 9 9 9 9 9 9 9 9 9 9 15 19 60 47 47 19 60 20 18 21 47 19 19 19 19 60 19 19 17 15 19 37 40 39 19 17 9 9 9 9 9 9 9 9 9 9
      9 9 9 9 9 9 9 9 9 9 9 9 15 19 19 37 42 19 19 17 9 15 37 40 40 40 39 19 19 19 17 15 24 25 26 47 19 17 9 9 9 9 9 9 9 9 9 9
      9 9 9 9 9 9 9 9 9 9 9 9 15 19 19 19 19 60 19 17 9 15 19 60 19 19 47 19 19 60 17 15 30 29 28 47 19 17 9 9 9 9 9 9 9 9 9 9
      9 9 9 9 9 9 9 9 9 9 9 9 14 18 18 18 18 18 18 13 9 14 18 18 21 19 47 19 20 18 13 15 19 19 19 47 60 17 9 9 9 9 9 9 9 9 9 9
      9 9 9 9 9 9 9 9 9 9 9 9 9 9 9 9 9 9 9 9 9 9 9 9 15 19 47 60 17 9 9 15 48 40 40 42 19 17 9 9 9 9 9 9 9 9 9 9
      9 9 9 9 9 9 9 9 9 9 9 9 9 9 9 9 9 9 9 9 9 9 9 9 15 19 47 19 23 16 16 22 47 19 60 19 19 17 9 9 9 9 9 9 9 9 9 9
      9 9 9 9 9 9 9 9 9 9 9 9 9 9 9 9 9 9 9 9 9 9 9 9 15 60 47 19 19 19 60 19 37 40 39 19 20 13 9 9 9 9 9 9 9 9 9 9
      9 9 9 9 9 9 9 9 9 9 9 9 9 9 9 9 9 9 9 9 9 9 9 9 15 19 37 40 40 40 40 40 40 40 42 19 17 9 9 9 9 9 9 9 9 9 9 9
      9 9 9 9 9 9 9 9 9 9 9 9 9 9 9 9 9 9 9 9 9 9 9 9 15 24 25 26 19 60 19 19 19 19 19 60 17 9 9 9 9 9 9 9 9 9 9 9
      9 9 9 9 9 9 9 9 9 9 9 9 9 9 9 9 9 9 9 9 9 9 9 9 15 30 29 28 20 18 18 18 18 18 18 18 13 9 9 9 9 9 9 9 9 9 9 9
      9 9 9 9 9 9 9 9 9 9 9 9 9 9 9 9 9 9 9 9 9 9 9 9 14 18 18 18 13 9 9 9 9 9 9 9 9 9 9 9 9 9 9 9 9 9 9 9
      9 9 9 9 9 9 9 9 9 9 9 9 9 9 9 9 9 9 9 9 9 9 9 9 9 9 9 9 9 9 9 9 9 9 9 9 9 9 9 9 9 9 9 9 9 9 9 9
      9 9 9 9 9 9 9 9 9 9 9 9 11 16 12 9 9 9 9 9 9 9 9 9 9 9 9 9 9 9 9 9 9 9 9 9 9 9 9 9 9 9 9 9 9 9 9 9
      9 9 9 9 9 9 9 9 9 9 9 9 15 58 17 9 9 9 9 9 9 9 9 9 9 9 9 9 9 9 9 9 9 9 9 9 9 9 9 9 9 9 9 9 9 9 9 9
      9 9 9 9 9 9 9 9 9 9 9 9 15 59 17 9 9 9 9 9 9 9 9 9 9 9 9 9 9 9 9 9 9 9 9 9 9 9 9 9 9 9 9 9 9 9 9 9
      9 9 9 9 9 9 9 9 9 9 9 9 15 47 17 9 9 9 9 9 9 9 9 9 9 9 9 9 9 9 9 9 9 9 9 9 9 9 9 9 9 9 9 9 9 9 9 9
      9 9 9 9 9 9 9 9 9 9 9 9 15 65 17 9 9 9 9 9 9 9 9 9 9 9 9 9 9 9 9 9 9 9 9 9 9 9 9 9 9 9 9 9 9 9 9 9
      9 9 9 9 9 9 9 9 9 9 9 9 15 68 17 9 9 9 9 9 9 9 9 9 9 9 9 9 9 9 9 9 9 9 9 9 9 9 9 9 9 9 9 9 9 9 9 9
      9 9 9 9 9 9 9 9 9 9 9 9 14 18 13 9 9 9 9 9 9 9 9 9 9 9 9 9 9 9 9 9 9 9 9 9 9 9 9 9 9 9 9 9 9 9 9 9
      9 9 9 9 9 9 9 9 9 9 9 9 9 9 9 9 9 9 9 9 9 9 9 9 9 9 9 9 9 9 9 9 9 9 9 9 9 9 9 9 9 9 9 9 9 9 9 9
      9 9 9 9 9 9 9 9 9 9 9 9 9 9 9 9 9 9 9 9 9 9 9 9 9 9 9 9 9 9 9 9 9 9 9 9 9 9 9 9 9 9 9 9 9 9 9 9
      9 9 9 9 9 9 9 9 9 9 9 9 9 9 9 9 9 9 9 9 9 9 9 9 9 9 9 9 9 9 9 9 9 9 9 9 9 9 9 9 9 9 9 9 9 9 9 9
      9 9 9 9 9 9 9 9 9 9 9 9 9 9 9 9 9 9 9 9 9 9 9 9 9 9 9 9 9 9 9 9 9 9 9 9 9 9 9 9 9 9 9 9 9 9 9 9
      9 9 9 9 9 9 9 9 9 9 9 9 9 9 9 9 9 9 9 9 9 9 9 9 9 9 9 9 9 9 9 9 9 9 9 9 9 9 9 9 9 9 9 9 9 9 9 9
      9 9 9 9 9 9 9 9 9 9 9 9 9 9 9 9 9 9 9 9 9 9 9 9 9 9 9 9 9 9 9 9 9 9 9 9 9 9 9 9 9 9 9 9 9 9 9 9
      9 9 9 9 9 9 9 9 9 9 9 9 9 9 9 9 9 9 9 9 9 9 9 9 9 9 9 9 9 9 9 9 9 9 9 9 9 9 9 9 9 9 9 9 9 9 9 9
      9 9 9 9 9 9 9 9 9 9 9 9 9 9 9 9 9 9 9 9 9 9 9 9 9 9 9 9 9 9 9 9 9 9 9 9 9 9 9 9 9 9 9 9 9 9 9 9
      9 9 9 9 9 9 9 9 9 9 9 9 9 9 9 9 9 9 9 9 9 9 9 9 9 9 9 9 9 9 9 9 9 9 9 9 9 9 9 9 9 9 9 9 9 9 9 9
      9 9 9 9 9 9 9 9 9 9 9 9 9 9 9 9 9 9 9 9 9 9 9 9 9 9 9 9 9 9 9 9 9 9 9 9 9 9 9 9 9 9 9 9 9 9 9 9
      )
    )
    (level
      (name "tsb-level00.stl")
      (auto-play #t)
      (sprite "images/objects/invisible/invisible.sprite")
      (x 15)
      (y 14)
    )
    (level
      (name "tsb-level01.stl")
      (x 15)
      (y 17)
    )
    (level
      (name "tsb-level02.stl")
      (x 16)
      (y 20)
    )
    (level
      (name "tsb-level03.stl")
      (x 17)
      (y 17)
    )
    (level
      (name "tsb-level04.stl")
      (x 21)
      (y 17)
    )
    (level
      (name "tsb-level05.stl")
      (x 22)
      (y 20)
    )
    (level
      (name "tsb-level06.stl")
      (x 26)
      (y 20)
    )
    (level
      (name "tsb-level07.stl")
      (x 26)
      (y 24)
    )
    (level
      (name "tsb-level08.stl")
      (x 28)
      (y 26)
    )
    (level
      (name "tsb-level09.stl")
      (x 32)
      (y 26)
    )
    (level
      (name "tsb-level10.stl")
      (x 33)
      (y 25)
    )
    (level
      (name "tsb-level11.stl")
      (x 33)
      (y 23)
    )
    (level
      (name "tsb-level12.stl")
      (x 35)
      (y 21)
    )
    (level
      (name "tsb-level13.stl")
      (x 33)
      (y 19)
    )
    (level
      (name "tsb-level14.stl")
      (x 35)
      (y 17)
    )
    (level
      (name "tsb-level15.stl")
      (x 33)
      (y 15)
    )
    (level
      (name "tsb-level16.stl")
      (x 29)
      (y 15)
    )
    (level
      (name "tsb-level17.stl")
      (x 30)
      (y 14)
    )
    (level
      (name "tsb-level18.stl")
      (extro-script "
wait_for_screenswitch(); //because it needs to exit the game screen
display_text_file(\"levels/tsb/extro-tsb.txt\");
")
      (x 29)
      (y 13)
    )
    (level
      (name "tsb-level19.stl")
      (x 13)
      (y 35)
    )
    (worldmap-spawnpoint
      (name "main")
      (x 15)
      (y 14)
    )
    (worldmap-spawnpoint
      (name "x6y24")
      (x 13)
      (y 34)
    )
    (worldmap-spawnpoint
      (name "x28y13")
      (x 35)
      (y 23)
    )
  )
  (tileset "images/worldmap.strf")
)
