(supertux-level
  (version 2)
  (name (_ "Kill Nolok !"))
  (author "Narre")
  (license "GPL 2+ / CC-by-sa 3.0")
  (sector
    (name "main")
    (music "music/treeboss.music")
    (ambient-light 1 1 1)
    (background
      (speed 0.5)
      (image-top "images/background/bluemountain-top.png")
      (image "images/background/bluemountain-middle.png")
      (image-bottom "images/background/bluemountain-bottom.png")
    )
    (camera
      (mode "normal")
    )
    (spawnpoint
      (name "main")
      (x 576)
      (y 384)
    )
    (tilemap
      (z-pos -100)
      (solid #f)
      (name "Background")
      (width 40)
      (height 17)
      (tiles
      2679 2680 2681 2682 2679 2680 2681 2682 2679 2680 2681 2682 2679 2680 2681 2682 2679 2680 2681 2682 2679 2680 2681 2682 2679 2680 2681 2682 2679 2680 2681 2682 2679 2680 2681 2682 2679 2680 2681 2682
      2695 2696 2697 2698 2695 2696 2697 2698 2695 2696 2697 2698 2695 2696 2697 2698 2695 2696 2697 2698 2695 2696 2697 2698 2695 2696 2697 2698 2695 2696 2697 2698 2695 2696 2697 2698 2695 2696 2697 2698
      2711 2712 2713 2714 2711 2712 2713 2714 2711 2712 2713 2714 2711 2712 2713 2714 2711 2712 2713 2714 2711 2712 2713 2714 2711 2712 2713 2714 2711 2712 2713 2714 2711 2712 2713 2714 2711 2712 2713 2714
      2727 2728 2729 2730 2727 2728 2729 2730 2727 2728 2729 2730 2727 2728 2729 2730 2727 2728 2729 2730 2727 2728 2729 2730 2727 2728 2729 2730 2727 2728 2729 2730 2727 2728 2729 2730 2727 2728 2729 2730
      2679 2680 2681 2682 2679 2680 2681 2682 2679 2680 2681 2682 2679 2680 2681 2682 2679 2680 2681 2682 2679 2680 2681 2682 2679 2680 2681 2682 2679 2680 2681 2682 2679 2680 2681 2682 2679 2680 2681 2682
      2695 2696 2697 2698 2695 2696 2697 2698 2695 2696 2697 2698 2695 2696 2697 2698 2695 2696 2697 2698 2695 2696 2697 2698 2695 2696 2697 2698 2695 2696 2697 2698 2695 2696 2697 2698 2695 2696 2697 2698
      2711 2712 2713 2714 2711 2712 2713 2714 2711 2712 2713 2714 2711 2712 2713 2714 2711 2712 2713 2714 2711 2712 2713 2714 2711 2712 2713 2714 2711 2712 2713 2714 2711 2712 2713 2714 2711 2712 2713 2714
      2727 2728 2729 2730 2727 2728 2729 2730 2727 2728 2729 2730 2727 2728 2729 2730 2727 2728 2729 2730 2727 2728 2729 2730 2727 2728 2729 2730 2727 2728 2729 2730 2727 2728 2729 2730 2727 2728 2729 2730
      2679 2680 2681 2682 2679 2680 2681 2682 2679 2680 2681 2682 2679 2680 2681 2682 2679 2680 2681 2682 2679 2680 2681 2682 2679 2680 2681 2682 2679 2680 2681 2682 2679 2680 2681 2682 2679 2680 2681 2682
      2695 2696 2697 2698 2695 2696 2697 2698 2695 2696 2697 2698 2695 2696 2697 2698 2695 2696 2697 2698 2695 2696 2697 2698 2695 2696 2697 2698 2695 2696 2697 2698 2695 2696 2697 2698 2695 2696 2697 2698
      2711 2712 2713 2714 2711 2712 2713 2714 2711 2712 2713 2714 2711 2712 2713 2714 2711 2712 2713 2714 2711 2712 2713 2714 2711 2712 2713 2714 2711 2712 2713 2714 2711 2712 2713 2714 2711 2712 2713 2714
      2727 2728 2729 2730 2727 2728 2729 2730 2727 2728 2729 2730 2727 2728 2729 2730 2727 2728 2729 2730 2727 2728 2729 2730 2727 2728 2729 2730 2727 2728 2729 2730 2727 2728 2729 2730 2727 2728 2729 2730
      2679 2680 2681 2682 2679 2680 2681 2682 2679 2680 2681 2682 2679 2680 2681 2682 2679 2680 2681 2682 2679 2680 2681 2682 2679 2680 2681 2682 2679 2680 2681 2682 2679 2680 2681 2682 2679 2680 2681 2682
      2695 2696 2697 2698 2695 2696 2697 2698 2695 2696 2697 2698 2695 2696 2697 2698 2695 2696 2697 2698 2695 2696 2697 2698 2695 2696 2697 2698 2695 2696 2697 2698 2695 2696 2697 2698 2695 2696 2697 2698
      2711 2712 2713 2714 2711 2712 2713 2714 2711 2712 2713 2714 2711 2712 2713 2714 2711 2712 2713 2714 2711 2712 2713 2714 2711 2712 2713 2714 2711 2712 2713 2714 2711 2712 2713 2714 2711 2712 2713 2714
      2727 2728 2729 2730 2727 2728 2729 2730 2727 2728 2729 2730 2727 2728 2729 2730 2727 2728 2729 2730 2727 2728 2729 2730 2727 2728 2729 2730 2727 2728 2729 2730 2727 2728 2729 2730 2727 2728 2729 2730
      0 0 0 0 0 0 0 0 0 0 0 0 0 0 0 0 0 0 0 0 0 0 0 0 0 0 0 0 0 0 0 0 0 0 0 0 0 0 0 0
      )
    )
    (tilemap
      (z-pos 0)
      (solid #t)
      (name "Interactive")
      (width 40)
      (height 17)
      (tiles
      0 0 0 0 0 0 0 0 0 0 0 0 0 0 0 0 0 0 0 0 0 0 0 0 0 0 0 0 0 0 0 0 0 0 0 0 0 0 0 0
      0 0 0 0 0 0 0 0 0 0 0 0 0 0 0 0 0 0 0 0 0 0 0 0 0 0 0 0 0 0 0 0 0 0 0 0 0 0 0 0
      0 0 0 0 0 0 0 0 0 0 0 0 0 0 0 0 0 0 0 0 0 0 0 0 0 0 0 0 0 0 0 0 0 0 0 0 0 0 0 0
      0 0 0 0 0 0 0 0 0 0 0 0 0 0 0 0 0 0 0 0 0 0 0 0 0 0 0 0 0 0 0 0 0 0 0 0 0 0 0 0
      0 0 0 0 0 0 0 0 0 0 0 0 0 0 0 0 0 0 0 0 0 0 0 0 0 0 0 0 0 0 0 0 0 0 0 0 0 0 0 0
      0 0 0 0 0 0 0 0 0 0 0 0 0 0 0 0 0 0 0 0 0 0 0 0 0 0 0 0 0 0 0 0 0 0 0 0 0 0 0 0
      0 0 0 0 0 0 0 0 0 0 0 0 0 0 0 0 0 0 0 0 0 0 0 0 0 0 0 0 0 0 0 0 0 0 0 0 0 0 0 0
      8 8 8 8 8 8 8 8 8 9 0 0 0 0 0 0 0 0 0 0 0 0 0 0 0 0 0 0 7 8 8 8 8 8 8 8 8 8 8 8
      14 14 14 14 14 14 14 14 14 15 0 0 0 0 0 0 0 0 0 0 0 0 0 0 0 0 0 0 13 14 14 14 14 14 14 14 14 14 14 14
      11 11 11 11 11 11 11 11 11 12 0 0 0 0 0 0 0 0 0 0 0 0 0 0 0 0 0 0 10 11 11 11 11 11 11 11 11 11 11 11
      11 11 11 11 11 11 11 11 11 12 0 0 0 0 0 0 0 0 0 0 0 0 0 0 0 0 0 0 10 11 11 11 11 11 11 11 11 11 11 11
      11 11 11 11 11 11 11 11 11 12 0 0 0 0 0 0 0 0 0 0 0 0 0 0 0 0 0 0 10 11 11 11 11 11 11 11 11 11 11 11
      11 11 11 11 11 11 19 11 11 12 0 0 0 0 0 0 0 0 0 0 0 0 0 0 0 0 0 0 10 11 11 19 11 11 11 11 11 11 11 11
      11 11 11 11 11 11 11 11 11 12 0 0 0 0 0 0 0 0 0 0 0 0 0 0 0 0 0 0 10 11 11 11 11 11 11 11 11 11 11 11
      11 11 11 11 11 11 11 11 11 12 0 0 0 0 0 0 0 0 0 0 0 0 0 0 0 0 0 0 10 11 11 11 11 11 11 11 11 11 11 11
      11 11 11 11 11 11 11 11 11 21 8 8 8 8 8 8 8 8 8 8 8 8 8 8 8 8 8 8 22 11 11 11 11 11 11 11 11 11 11 11
      11 11 11 11 11 11 11 11 11 20 14 14 14 14 14 14 14 14 14 14 14 14 14 14 14 14 14 14 23 11 11 11 11 11 11 11 11 11 11 11
      )
    )
    (tilemap
      (z-pos 100)
      (solid #f)
      (name "Foreground")
      (width 40)
      (height 17)
      (tiles
      0 0 0 0 0 0 0 0 0 0 0 0 0 0 0 0 0 0 0 0 0 0 0 0 0 0 0 0 0 0 0 0 0 0 0 0 0 0 0 0
      0 0 0 0 0 0 0 0 0 0 0 0 0 0 0 0 0 0 0 0 0 0 0 0 0 0 0 0 0 0 0 0 0 0 0 0 0 0 0 0
      0 0 0 0 0 0 0 0 0 0 0 0 0 0 0 0 0 0 0 0 0 0 0 0 0 0 0 0 0 0 0 0 0 0 0 0 0 0 0 0
      0 0 0 0 0 0 0 0 0 0 0 0 0 0 0 0 0 0 0 0 0 0 0 0 0 0 0 0 0 0 0 0 0 0 0 0 0 0 0 0
      0 0 0 0 0 0 0 0 0 0 0 0 0 0 0 0 0 0 0 0 0 0 0 0 0 0 0 0 0 0 0 0 0 0 0 0 0 0 0 0
      0 0 0 0 0 0 0 0 0 0 0 0 0 0 0 0 0 0 0 0 0 0 0 0 0 0 0 0 0 0 0 0 0 0 0 0 0 0 0 0
      0 0 0 0 0 0 0 0 0 0 0 0 0 0 0 0 0 0 0 0 0 0 0 0 0 0 0 0 0 0 0 0 0 0 0 0 0 0 0 0
      0 0 0 0 0 0 0 0 0 0 0 0 0 0 0 0 0 0 0 0 0 0 0 0 0 0 0 0 0 0 0 0 0 0 0 0 0 0 0 0
      0 0 0 0 0 0 0 0 0 0 0 0 0 0 0 0 0 0 0 0 0 0 0 0 0 0 0 0 0 0 0 0 0 0 0 0 0 0 0 0
      0 0 0 0 0 0 0 0 0 0 0 0 0 0 0 0 0 0 0 0 0 0 0 0 0 0 0 0 0 0 0 0 0 0 0 0 0 0 0 0
      0 0 0 0 0 0 0 0 0 0 0 0 0 0 0 0 0 0 0 0 0 0 0 0 0 0 0 0 0 0 0 0 0 0 0 0 0 0 0 0
      0 0 0 0 0 0 0 0 0 0 0 0 0 0 0 0 0 0 0 0 0 0 0 0 0 0 0 0 0 0 0 0 0 0 0 0 0 0 0 0
      0 0 0 0 0 0 0 0 0 0 0 0 0 0 0 0 0 0 0 0 0 0 0 0 0 0 0 0 0 0 0 0 0 0 0 0 0 0 0 0
      0 0 0 0 0 0 0 0 0 0 0 0 0 0 0 0 0 0 0 0 0 0 0 0 0 0 0 0 0 0 0 0 0 0 0 0 0 0 0 0
      0 0 0 0 0 0 0 0 0 0 0 0 0 0 0 0 0 0 0 0 0 0 0 0 0 0 0 0 0 0 0 0 0 0 0 0 0 0 0 0
      0 0 0 0 0 0 0 0 0 0 0 0 0 0 0 0 0 0 0 0 0 0 0 0 0 0 0 0 0 0 0 0 0 0 0 0 0 0 0 0
      0 0 0 0 0 0 0 0 0 0 0 0 0 0 0 0 0 0 0 0 0 0 0 0 0 0 0 0 0 0 0 0 0 0 0 0 0 0 0 0
      )
    )
    (yeti
      (sprite "images/creatures/nolok/nolok.sprite")
      (dead-script "sector.Tux.trigger_sequence(\"fireworks\")")
      (x 32)
      (y 128)
    )
  )
)
