(supertux-level
  (version 2)
  (name (_ "Bonus Level 1 - wheel of fortune"))
  (author "hume") (license "GPL 2+ / CC-by-sa 3.0")
  (sector
    (name "main")
    (init-script "import(\"levels/hume/defualt.nut\")
unlock_archivement(\"j\")
unlock_archivement(\"g\")")
    (ambient-light 1 1 1)
    (background
      (speed 0.5)
      (image-top "images/background/arctis_top.jpg")
      (image "images/background/arctis.jpg")
      (image-bottom "images/background/arctis_bottom.jpg")
    )
    (camera
      (mode "normal")
    )
    (dispenser
      (badguy "snowball")
      (cycle 5)
      (x 544)
      (y 128)
    )
    (dispenser
      (badguy "mriceblock")
      (cycle 5)
      (x 672)
      (y 128)
    )
    (dispenser
      (badguy "skullyhop")
      (cycle 5)
      (x 160)
      (y 128)
    )
    (dispenser
      (badguy "bouncingsnowball")
      (cycle 5)
      (x 288)
      (y 128)
    )
    (dispenser
      (badguy "poisonivy")
      (cycle 5)
      (x 416)
      (y 128)
    )
    (door
      (sector "exit")
      (spawnpoint "main")
      (x 736)
      (y 704)
    )
    (firefly
      (x 864)
      (y 192)
      (sprite "images/objects/resetpoints/bell.sprite")
    )
    (platform
      (name "float1")
      (sprite "images/objects/platforms/icefloe_small.sprite")
      (path
        (node
          (x 160)
          (y 800)
        )
        (node
          (x 32)
          (y 800)
          (time 0.1)
        )
        (node
          (x 0)
          (y 800)
          (time 0.1)
        )
        (node
          (x 0)
          (y 960)
          (time 0.1)
        )
        (node
          (x 928)
          (y 960)
          (time 0.7)
        )
        (node
          (x 928)
          (y 800)
          (time 6)
        )
      )
    )
    (platform
      (name "float2")
      (sprite "images/objects/platforms/icefloe_small.sprite")
      (path
        (node
          (x 288)
          (y 800)
          (time 2)
        )
        (node
          (x 32)
          (y 800)
          (time 0.1)
        )
        (node
          (x 0)
          (y 800)
          (time 0.1)
        )
        (node
          (x 0)
          (y 960)
          (time 0.1)
        )
        (node
          (x 928)
          (y 960)
          (time 0.7)
        )
        (node
          (x 928)
          (y 800)
          (time 5)
        )
      )
    )
    (platform
      (name "float3")
      (sprite "images/objects/platforms/icefloe_small.sprite")
      (path
        (node
          (x 416)
          (y 800)
          (time 3)
        )
        (node
          (x 32)
          (y 800)
          (time 0.1)
        )
        (node
          (x 0)
          (y 800)
          (time 0.1)
        )
        (node
          (x 0)
          (y 960)
          (time 0.1)
        )
        (node
          (x 928)
          (y 960)
          (time 0.7)
        )
        (node
          (x 928)
          (y 800)
          (time 4)
        )
      )
    )
    (platform
      (name "float4")
      (sprite "images/objects/platforms/icefloe_small.sprite")
      (path
        (node
          (x 544)
          (y 800)
          (time 4)
        )
        (node
          (x 32)
          (y 800)
          (time 0.1)
        )
        (node
          (x 0)
          (y 800)
          (time 0.1)
        )
        (node
          (x 0)
          (y 960)
          (time 0.1)
        )
        (node
          (x 928)
          (y 960)
          (time 0.7)
        )
        (node
          (x 928)
          (y 800)
          (time 3)
        )
      )
    )
    (platform
      (name "float5")
      (sprite "images/objects/platforms/icefloe_small.sprite")
      (path
        (node
          (x 672)
          (y 800)
          (time 5)
        )
        (node
          (x 32)
          (y 800)
          (time 0.1)
        )
        (node
          (x 0)
          (y 800)
          (time 0.1)
        )
        (node
          (x 0)
          (y 960)
          (time 0.1)
        )
        (node
          (x 928)
          (y 960)
          (time 0.7)
        )
        (node
          (x 928)
          (y 800)
          (time 2)
        )
      )
    )
    (platform
      (name "float6")
      (sprite "images/objects/platforms/icefloe_small.sprite")
      (path
        (node
          (x 800)
          (y 800)
          (time 6)
        )
        (node
          (x 32)
          (y 800)
          (time 0.1)
        )
        (node
          (x 0)
          (y 800)
          (time 0.1)
        )
        (node
          (x 0)
          (y 960)
          (time 0.1)
        )
        (node
          (x 928)
          (y 960)
          (time 0.7)
        )
        (node
          (x 928)
          (y 800)
        )
      )
    )
    (platform
      (name "float0")
      (sprite "images/objects/platforms/icefloe_small.sprite")
      (path
        (node
          (x 32)
          (y 800)
          (time 0.1)
        )
        (node
          (x 0)
          (y 800)
          (time 0.1)
        )
        (node
          (x 0)
          (y 960)
          (time 0.1)
        )
        (node
          (x 928)
          (y 960)
          (time 0.7)
        )
        (node
          (x 928)
          (y 800)
          (time 7)
        )
      )
    )
    (platform
      (name "float7")
      (sprite "images/objects/platforms/icefloe_small.sprite")
      (path
        (node
          (x 928)
          (y 800)
          (time 7)
        )
        (node
          (x 32)
          (y 800)
          (time 0.1)
        )
        (node
          (x 0)
          (y 800)
          (time 0.1)
        )
        (node
          (x 0)
          (y 960)
          (time 0.1)
        )
        (node
          (x 928)
          (y 960)
          (time 0.7)
        )
      )
    )
    (platform
      (name "badguy0")
      (running #f)
      (sprite "images/objects/platforms/small.sprite")
      (path
        (node
          (x 160)
          (y 256)
          (time 4)
        )
        (node
          (x 224)
          (y 256)
          (time 0.1)
        )
      )
    )
    (platform
      (name "badguy1")
      (running #f)
      (sprite "images/objects/platforms/small.sprite")
      (path
        (node
          (x 288)
          (y 256)
          (time 4)
        )
        (node
          (x 352)
          (y 256)
          (time 0.1)
        )
      )
    )
    (platform
      (name "badguy2")
      (running #f)
      (sprite "images/objects/platforms/small.sprite")
      (path
        (node
          (x 416)
          (y 256)
          (time 4)
        )
        (node
          (x 480)
          (y 256)
          (time 0.1)
        )
      )
    )
    (platform
      (name "badguy3")
      (running #f)
      (sprite "images/objects/platforms/small.sprite")
      (path
        (node
          (x 544)
          (y 256)
          (time 4)
        )
        (node
          (x 608)
          (y 256)
          (time 0.1)
        )
      )
    )
    (platform
      (name "badguy4")
      (running #f)
      (sprite "images/objects/platforms/small.sprite")
      (path
        (node
          (x 672)
          (y 256)
          (time 4)
        )
        (node
          (x 736)
          (y 256)
          (time 0.1)
        )
      )
    )
    (platform
      (name "brana")
      (running #f)
      (sprite "images/objects/platforms/pedestal.sprite")
      (path
        (node
          (x 896)
          (y 608)
          (time 0.1)
        )
        (node
          (x 800)
          (y 608)
        )
      )
    )
    (scripttrigger
      (script "set_game_speed(1);
wheel.bonus <- 1
Tux.kill(true);")
      (button #f)
      (width 32)
      (height 508)
      (x 160)
      (y 288)
    )
    (scripttrigger
      (script "play_music(\"music/invincible.ogg\");
brana.goto_node(1);
wait(90);
set_game_speed(1);
settings.set_ambient_light(1,1,1);
this.party <- true;
Text.set_text(\"Party over!\\n-500 coins\");
sector.Tux.add_coins(-100*wheel.bonus);
sector.Tux.add_coins(-100*wheel.bonus);
sector.Tux.add_coins(-100*wheel.bonus);
sector.Tux.add_coins(-100*wheel.bonus);
sector.Tux.add_coins(-100*wheel.bonus);
Text.fade_in(0.2);
sector.Tux.trigger_sequence(\"fireworks\");")
      (button #f)
      (width 28)
      (height 72)
      (x 821.2131)
      (y 669.6985)
    )
    (scripttrigger
      (script "if(!(\"party\"in this)){
import(\"levels/hume/bonus1.nut\");vylosuj();}")
      (button #f)
      (width 636)
      (height 32)
      (x 160)
      (y 768)
    )
    (spawnpoint
      (name "main")
      (x 864)
      (y 160)
    )
    (spotlight
      (angle 165)
      (color 0 0.2509804 0)
      (x 458)
      (y 525)
    )
    (spotlight
      (angle 0)
      (color 1 0 0)
      (x 458)
      (y 525)
    )
    (spotlight
      (angle 15)
      (color 0.7529412 0 0)
      (x 458)
      (y 525)
    )
    (spotlight
      (angle 30)
      (color 0.5019608 0 0)
      (x 458)
      (y 525)
    )
    (spotlight
      (angle 45)
      (color 0.2509804 0 0)
      (x 458)
      (y 525)
    )
    (spotlight
      (angle 60)
      (color 0 0 1)
      (x 458)
      (y 525)
    )
    (spotlight
      (angle 75)
      (color 0 0 0.7529412)
      (x 458)
      (y 525)
    )
    (spotlight
      (angle 90)
      (color 0 0 0.5019608)
      (x 458)
      (y 525)
    )
    (spotlight
      (angle 105)
      (color 0 0 0.2509804)
      (x 458)
      (y 525)
    )
    (spotlight
      (angle 120)
      (color 0 1 0)
      (x 458)
      (y 525)
    )
    (spotlight
      (angle 135)
      (color 0 0.7529412 0)
      (x 458)
      (y 525)
    )
    (spotlight
      (angle 150)
      (color 0 0.5019608 0)
      (x 458)
      (y 525)
    )
    (tilemap
      (z-pos -100)
      (solid #f)
      (name "Background")
      (width 30)
      (height 30)
      (tiles
      0 0 0 0 0 0 0 0 0 0 0 0 0 0 0 0 0 0 0 0 0 0 0 0 0 0 0 0 0 0
      0 0 0 0 0 0 0 0 0 0 0 0 0 0 0 0 0 0 0 0 0 0 0 0 0 0 0 0 0 0
      0 0 0 0 0 0 0 0 0 0 0 0 0 0 0 0 0 0 0 0 0 0 0 0 0 0 0 0 0 0
      0 0 0 0 0 0 0 0 0 0 0 0 0 0 0 0 0 0 0 0 0 0 0 0 0 0 0 0 0 0
      0 0 0 0 0 0 0 0 0 0 0 0 0 0 0 0 0 0 0 0 0 0 0 0 0 0 0 0 0 0
      0 0 0 0 0 0 0 0 0 0 0 0 0 0 0 0 0 0 0 0 0 0 0 0 0 0 0 0 0 0
      0 0 0 2814 0 0 0 0 0 0 0 0 0 0 0 0 0 0 0 0 0 0 0 0 0 2813 0 0 0 0
      0 0 0 2816 2814 0 0 0 0 0 0 0 0 0 0 0 0 0 0 0 0 0 0 0 2813 2815 0 0 0 0
      0 0 0 0 2816 2814 0 0 0 0 0 0 0 0 0 0 0 0 0 0 0 0 0 2813 2815 0 0 0 0 0
      0 0 0 0 0 2816 2814 0 0 0 0 0 0 0 0 0 0 0 0 0 0 0 2813 2815 0 0 0 0 0 0
      0 0 0 0 0 0 2816 2814 0 0 0 0 0 48 48 48 0 0 0 0 0 2813 2815 0 0 0 0 0 0 0
      0 0 0 0 0 0 0 2816 2814 0 0 48 48 0 44 0 48 48 0 0 2813 2815 0 0 0 0 0 0 0 0
      0 0 0 0 0 0 0 0 2816 2814 48 0 44 0 0 0 44 0 48 2813 2815 0 0 0 0 0 0 0 0 0
      0 0 0 0 0 0 0 0 0 48 0 0 0 0 0 0 0 0 0 48 0 0 0 0 0 0 0 0 0 0
      0 0 0 1827 0 0 0 0 0 48 44 0 0 0 0 0 0 0 44 48 0 0 0 0 0 0 0 0 0 0
      0 0 0 0 0 0 0 0 48 0 0 0 0 0 0 0 0 0 0 0 48 0 0 0 0 0 0 0 0 0
      0 0 0 0 0 0 0 0 48 44 0 0 0 0 0 0 0 0 0 44 48 0 0 0 0 0 0 0 0 0
      0 0 0 0 0 0 0 0 48 0 0 0 0 0 0 0 0 0 0 0 48 0 0 0 0 0 0 0 0 0
      0 0 0 0 0 0 0 0 0 48 44 0 0 0 0 0 0 0 44 48 0 0 0 0 0 0 0 0 0 0
      0 0 0 0 0 0 0 0 0 48 0 0 0 0 0 0 0 0 0 48 0 0 0 0 0 0 0 0 0 0
      0 0 0 0 0 0 0 0 0 2813 48 0 44 0 0 0 44 0 48 2814 0 0 0 0 0 0 0 0 0 0
      0 0 0 0 0 0 0 0 2813 2815 0 48 48 0 44 0 48 48 0 2816 2814 0 0 0 0 0 0 0 0 0
      0 0 0 0 0 0 0 2813 2815 0 0 0 0 48 48 48 0 0 0 0 2816 2814 0 0 0 0 0 0 0 0
      0 0 0 0 0 0 2813 2815 0 0 0 0 0 0 0 0 0 0 0 0 0 2816 2814 0 0 0 0 0 0 0
      0 0 0 0 0 2813 2815 0 0 0 0 0 0 0 0 0 0 0 0 0 0 0 2816 2814 0 0 0 0 0 0
      0 0 0 0 2813 2815 0 0 0 0 0 0 0 0 0 0 0 0 0 0 0 0 0 2816 2814 0 0 0 0 0
      0 0 0 0 2815 0 0 0 0 0 0 0 0 0 0 0 0 0 0 0 0 0 0 0 2816 2814 0 0 0 0
      0 0 0 0 0 0 0 0 0 0 0 0 0 0 0 0 0 0 0 0 0 0 0 0 0 2816 0 0 0 0
      0 0 0 0 0 0 0 0 0 0 0 0 0 0 0 0 0 0 0 0 0 0 0 0 0 0 0 0 0 0
      0 0 0 0 0 0 0 0 0 0 0 0 0 0 0 0 0 0 0 0 0 0 0 0 0 0 0 0 0 0
      )
    )
    (tilemap
      (z-pos 0)
      (solid #t)
      (name "Interactive")
      (width 30)
      (height 30)
      (tiles
      11 11 11 11 11 11 11 11 11 11 11 11 11 11 11 11 11 11 11 11 11 11 11 11 11 11 11 11 11 11
      11 11 11 11 11 11 11 11 11 11 11 11 11 11 11 11 11 11 11 11 11 11 11 11 11 11 11 11 11 11
      11 11 11 11 11 11 11 11 11 11 11 11 11 11 11 11 11 11 11 11 11 11 11 11 11 11 11 11 11 11
      11 11 11 11 11 11 11 11 11 11 11 11 11 11 11 11 11 11 11 11 11 11 11 11 11 11 11 11 11 11
      11 11 11 11 30 17 17 31 30 17 17 31 30 17 17 31 30 17 17 31 30 17 17 31 30 31 12 0 10 11
      11 11 11 11 12 0 0 10 12 0 0 10 12 0 0 10 12 0 0 10 12 0 0 10 12 10 12 0 10 11
      11 11 11 11 12 0 0 10 12 0 0 10 12 0 0 10 12 0 0 10 12 0 0 10 12 10 12 0 10 11
      11 11 11 11 12 0 0 10 12 0 0 10 12 0 0 10 12 0 0 10 12 0 0 10 12 10 12 0 10 11
      11 11 11 11 12 0 0 16 18 0 0 16 18 0 0 16 18 0 0 16 18 0 0 16 18 10 12 0 10 11
      11 11 11 11 48 0 0 0 0 0 0 0 0 0 0 0 0 0 0 0 0 0 0 0 0 10 12 0 10 11
      11 11 11 11 48 0 0 0 0 0 0 0 0 0 0 0 0 0 0 0 0 0 0 0 0 10 12 0 10 11
      11 11 11 11 48 0 0 0 0 0 0 0 0 0 0 0 0 0 0 0 0 0 0 0 0 10 12 0 10 11
      11 11 11 11 48 0 0 0 0 0 0 0 0 0 0 0 0 0 0 0 0 0 0 0 0 10 12 0 10 11
      11 11 11 11 48 0 0 0 0 0 0 0 0 0 0 0 0 0 0 0 0 0 0 0 0 10 12 0 10 11
      11 11 11 11 48 0 0 0 0 0 0 0 0 0 0 0 0 0 0 0 0 0 0 0 0 10 12 0 10 11
      11 11 11 11 48 0 0 0 0 0 0 0 0 0 0 0 0 0 0 2676 0 0 0 0 0 10 12 0 10 11
      11 11 11 11 48 0 0 0 0 0 0 0 0 0 0 0 0 0 0 0 0 0 0 0 0 10 12 0 10 11
      11 11 11 11 48 0 0 0 0 0 0 0 0 0 0 0 0 0 0 0 0 0 0 0 0 10 12 0 10 11
      11 11 11 11 48 0 0 0 0 0 0 0 0 0 0 0 0 0 0 0 0 0 0 0 0 10 12 0 10 11
      11 11 11 11 48 0 0 0 0 0 0 0 0 0 0 0 0 0 0 0 0 0 0 0 0 10 12 0 10 11
      11 11 11 11 48 0 0 0 0 0 0 0 0 0 0 0 0 0 0 0 0 0 0 0 0 10 12 0 10 11
      11 11 11 11 48 0 0 0 0 0 0 0 0 0 0 0 0 0 0 0 0 0 0 0 0 0 0 0 10 11
      11 11 11 11 48 0 0 0 0 0 0 0 0 0 0 0 0 0 0 0 0 0 0 0 0 0 0 0 10 11
      11 11 11 11 48 0 0 0 0 0 0 0 0 0 0 0 0 0 0 0 0 0 0 0 0 10 11 11 11 11
      11 11 11 11 48 0 0 0 0 0 0 0 0 0 0 0 0 0 0 0 0 0 0 0 0 10 11 11 11 11
      11 11 11 11 12 0 0 0 0 0 0 0 0 0 0 0 0 0 0 0 0 0 0 0 0 10 11 11 11 11
      11 11 11 11 12 0 0 0 0 0 0 0 0 0 0 0 0 0 0 0 0 0 0 0 0 10 11 11 11 11
      11 11 11 11 12 0 0 0 0 0 0 0 0 0 0 0 0 0 0 0 0 0 0 0 0 10 11 11 11 11
      11 11 11 11 12 0 0 0 0 0 0 0 0 0 0 0 0 0 0 0 0 0 0 0 0 10 11 11 11 11
      11 11 11 11 12 0 0 0 0 0 0 0 0 0 0 0 0 0 0 0 0 0 0 0 0 10 11 11 11 11
      )
    )
    (tilemap
      (z-pos 100)
      (solid #f)
      (name "Foreground")
      (width 30)
      (height 30)
      (tiles
      11 11 11 11 11 11 11 11 11 11 11 11 11 11 11 11 11 11 11 11 11 11 11 11 11 11 11 11 11 11
      11 11 11 11 11 11 11 11 11 11 11 11 11 11 11 11 11 11 11 11 11 11 11 11 11 11 11 11 11 11
      11 11 11 11 11 11 11 11 11 11 11 11 11 11 11 11 11 11 11 11 11 11 11 11 11 11 11 11 11 11
      11 11 11 11 11 11 11 11 11 11 11 11 11 11 11 11 11 11 11 11 11 11 11 11 11 11 11 11 11 11
      11 11 11 11 30 17 17 31 30 17 17 31 30 17 17 31 30 17 17 31 30 17 17 31 30 31 30 17 31 11
      11 11 11 11 12 0 0 10 12 0 0 10 12 0 0 10 12 0 0 10 12 0 0 10 12 10 12 0 10 11
      11 11 11 11 12 0 0 10 12 0 0 10 12 0 0 10 12 0 0 10 12 0 0 10 12 10 12 0 10 11
      11 11 11 11 12 0 0 10 12 0 0 10 12 0 0 10 12 0 0 10 12 0 0 10 12 10 12 0 10 11
      11 11 11 11 12 0 0 16 18 0 0 16 18 0 0 16 18 0 0 16 18 0 0 16 18 10 12 0 10 11
      11 11 11 11 12 296 0 0 0 0 0 0 0 0 0 0 0 0 0 0 0 0 0 0 0 10 12 0 10 11
      11 11 11 11 12 296 0 0 0 0 0 0 0 0 0 0 0 0 0 0 0 0 0 0 0 10 12 0 10 11
      11 11 11 11 12 296 0 0 0 0 0 0 0 0 0 0 0 0 0 0 0 0 0 0 0 10 12 0 10 11
      11 11 11 11 12 296 0 0 0 0 0 0 0 0 0 0 0 0 0 0 0 0 0 0 0 10 12 0 10 11
      11 11 11 11 12 296 0 0 0 0 0 0 0 0 0 0 0 0 0 0 0 0 0 0 0 10 12 0 10 11
      11 11 11 11 12 296 0 0 0 0 0 0 0 0 0 0 0 0 0 0 0 0 2675 0 0 10 12 0 10 11
      11 11 11 11 12 296 0 0 0 0 0 0 0 0 0 0 0 0 0 0 0 0 2675 2675 0 10 12 0 10 11
      11 11 11 11 12 296 0 0 0 0 0 0 0 0 0 0 0 0 0 84 0 2675 2675 2675 0 10 12 0 10 11
      11 11 11 11 12 296 0 0 0 0 0 0 0 0 0 0 0 0 0 0 0 2675 2675 2675 0 10 12 0 10 11
      11 11 11 11 12 296 0 0 0 0 0 0 0 0 0 0 0 0 0 0 0 2675 2675 2675 0 10 12 0 10 11
      11 11 11 11 12 296 0 0 0 0 0 0 0 0 0 0 0 0 0 0 0 0 0 0 0 10 12 0 10 11
      11 11 11 11 12 296 0 0 0 0 0 0 0 0 0 0 0 0 0 0 0 0 0 0 0 10 12 0 10 11
      11 11 11 11 12 296 0 0 0 0 0 0 0 0 0 0 0 0 0 0 0 0 0 0 0 16 18 0 10 11
      11 11 11 11 12 296 0 0 0 0 0 0 0 0 0 0 0 0 0 0 0 0 0 0 0 7 8 8 22 11
      11 11 11 11 12 296 0 0 0 0 0 0 0 0 0 0 0 0 0 0 0 0 0 0 0 13 14 14 23 11
      11 11 11 11 12 296 0 0 0 0 0 0 0 0 0 0 0 0 0 0 0 0 0 0 0 10 11 11 11 11
      2019 2140 2141 2142 2019 2140 2141 2142 2019 2140 2141 2142 2019 2140 2141 2142 2019 2140 2141 2142 2019 2140 2141 2142 2019 2140 2141 2142 2019 2140
      2020 2020 2020 2020 2020 2020 2020 2020 2020 2020 2020 2020 2020 2020 2020 2020 2020 2020 2020 2020 2020 2020 2020 2020 2020 2020 2020 2020 2020 2020
      2020 2020 2020 2020 2020 2020 2020 2020 2020 2020 2020 2020 2020 2020 2020 2020 2020 2020 2020 2020 2020 2020 2020 2020 2020 2020 2020 2020 2020 2020
      2020 2020 2020 2020 2020 2020 2020 2020 2020 2020 2020 2020 2020 2020 2020 2020 2020 2020 2020 2020 2020 2020 2020 2020 2020 2020 2020 2020 2020 2020
      2020 2020 2020 2020 2020 2020 2020 2020 2020 2020 2020 2020 2020 2020 2020 2020 2020 2020 2020 2020 2020 2020 2020 2020 2020 2020 2020 2020 2020 2020
      )
    )
  )
  (sector
    (name "exit")
    (init-script "Tux.deactivate();
set_game_speed(1);
Text.set_text(\"Stuck!??\\n-300 coins\");
sector.Tux.add_coins(-100);
sector.Tux.add_coins(-100);
sector.Tux.add_coins(-100);
Text.fade_in(0.2);
sector.Tux.trigger_sequence(\"fireworks\");
wait(5);
Level.finish(true);
")
    (ambient-light 1 1 1)
    (background
      (speed 0.5)
      (image-top "images/background/arctis_top.jpg")
      (image "images/background/arctis.jpg")
      (image-bottom "images/background/arctis_bottom.jpg")
    )
    (camera
      (mode "manual")
    )
    (spawnpoint
      (name "main")
      (x 512)
      (y 512)
    )
    (tilemap
      (z-pos -100)
      (solid #f)
      (name "Background")
      (width 35)
      (height 35)
      (tiles
      0 0 0 0 0 0 0 0 0 0 0 0 0 0 0 0 0 0 0 0 0 0 0 0 0 0 0 0 0 0 0 0 0 0 0
      0 0 0 0 0 0 0 0 0 0 0 0 0 0 0 0 0 0 0 0 0 0 0 0 0 0 0 0 0 0 0 0 0 0 0
      0 0 0 0 0 0 0 0 0 0 0 0 0 0 0 0 0 0 0 0 0 0 0 0 0 0 0 0 0 0 0 0 0 0 0
      0 0 0 0 0 0 0 0 0 0 0 0 0 0 0 0 0 0 0 0 0 0 0 0 0 0 0 0 0 0 0 0 0 0 0
      0 0 0 0 0 0 0 0 0 0 0 0 0 0 0 0 0 0 0 0 0 0 0 0 0 0 0 0 0 0 0 0 0 0 0
      0 0 0 0 0 0 0 0 0 0 0 0 0 0 0 0 0 0 0 0 0 0 0 0 0 0 0 0 0 0 0 0 0 0 0
      0 0 0 0 0 0 0 0 0 0 0 0 0 0 0 0 0 0 0 0 0 0 0 0 0 0 0 0 0 0 0 0 0 0 0
      0 0 0 0 0 0 0 0 0 0 0 0 0 0 0 0 0 0 0 0 0 0 0 0 0 0 0 0 0 0 0 0 0 0 0
      0 0 0 0 0 0 0 0 0 0 0 0 0 0 0 0 0 0 0 0 0 0 0 0 0 0 0 0 0 0 0 0 0 0 0
      0 0 0 0 0 0 0 0 0 0 0 0 0 0 0 0 0 0 0 0 0 0 0 0 0 0 0 0 0 0 0 0 0 0 0
      0 0 0 0 0 0 0 0 0 0 0 0 0 0 0 0 0 0 0 0 0 0 0 0 0 0 0 0 0 0 0 0 0 0 0
      0 0 0 0 0 0 0 0 0 0 0 0 0 0 0 0 0 0 0 0 0 0 0 0 0 0 0 0 0 0 0 0 0 0 0
      0 0 0 0 0 0 0 0 0 0 0 0 0 0 0 0 0 0 0 0 0 0 0 0 0 0 0 0 0 0 0 0 0 0 0
      0 0 0 0 0 0 0 0 0 0 0 0 0 0 0 0 0 0 0 0 0 0 0 0 0 0 0 0 0 0 0 0 0 0 0
      0 0 0 0 0 0 0 0 0 0 0 0 0 0 0 0 0 0 0 0 0 0 0 0 0 0 0 0 0 0 0 0 0 0 0
      0 0 0 0 0 0 0 0 0 0 0 0 0 0 0 0 0 0 0 0 0 0 0 0 0 0 0 0 0 0 0 0 0 0 0
      0 0 0 0 0 0 0 0 0 0 0 0 0 0 0 0 0 0 0 0 0 0 0 0 0 0 0 0 0 0 0 0 0 0 0
      0 0 0 0 0 0 0 0 0 0 0 0 0 0 0 0 0 0 0 0 0 0 0 0 0 0 0 0 0 0 0 0 0 0 0
      0 0 0 0 0 0 0 0 0 0 0 0 0 0 0 0 0 0 0 0 0 0 0 0 0 0 0 0 0 0 0 0 0 0 0
      0 0 0 0 0 0 0 0 0 0 0 0 0 0 0 0 0 0 0 0 0 0 0 0 0 0 0 0 0 0 0 0 0 0 0
      0 0 0 0 0 0 0 0 0 0 0 0 0 0 0 0 0 0 0 0 0 0 0 0 0 0 0 0 0 0 0 0 0 0 0
      0 0 0 0 0 0 0 0 0 0 0 0 0 0 0 0 0 0 0 0 0 0 0 0 0 0 0 0 0 0 0 0 0 0 0
      0 0 0 0 0 0 0 0 0 0 0 0 0 0 0 0 0 0 0 0 0 0 0 0 0 0 0 0 0 0 0 0 0 0 0
      0 0 0 0 0 0 0 0 0 0 0 0 0 0 0 0 0 0 0 0 0 0 0 0 0 0 0 0 0 0 0 0 0 0 0
      0 0 0 0 0 0 0 0 0 0 0 0 0 0 0 0 0 0 0 0 0 0 0 0 0 0 0 0 0 0 0 0 0 0 0
      0 0 0 0 0 0 0 0 0 0 0 0 0 0 0 0 0 0 0 0 0 0 0 0 0 0 0 0 0 0 0 0 0 0 0
      0 0 0 0 0 0 0 0 0 0 0 0 0 0 0 0 0 0 0 0 0 0 0 0 0 0 0 0 0 0 0 0 0 0 0
      0 0 0 0 0 0 0 0 0 0 0 0 0 0 0 0 0 0 0 0 0 0 0 0 0 0 0 0 0 0 0 0 0 0 0
      0 0 0 0 0 0 0 0 0 0 0 0 0 0 0 0 0 0 0 0 0 0 0 0 0 0 0 0 0 0 0 0 0 0 0
      0 0 0 0 0 0 0 0 0 0 0 0 0 0 0 0 0 0 0 0 0 0 0 0 0 0 0 0 0 0 0 0 0 0 0
      0 0 0 0 0 0 0 0 0 0 0 0 0 0 0 0 0 0 0 0 0 0 0 0 0 0 0 0 0 0 0 0 0 0 0
      0 0 0 0 0 0 0 0 0 0 0 0 0 0 0 0 0 0 0 0 0 0 0 0 0 0 0 0 0 0 0 0 0 0 0
      0 0 0 0 0 0 0 0 0 0 0 0 0 0 0 0 0 0 0 0 0 0 0 0 0 0 0 0 0 0 0 0 0 0 0
      0 0 0 0 0 0 0 0 0 0 0 0 0 0 0 0 0 0 0 0 0 0 0 0 0 0 0 0 0 0 0 0 0 0 0
      0 0 0 0 0 0 0 0 0 0 0 0 0 0 0 0 0 0 0 0 0 0 0 0 0 0 0 0 0 0 0 0 0 0 0
      )
    )
    (tilemap
      (z-pos 0)
      (solid #t)
      (name "Interactive")
      (width 35)
      (height 35)
      (tiles
      0 0 0 0 0 0 0 0 0 0 0 0 0 0 0 0 0 0 0 0 0 0 0 0 0 0 0 0 0 0 0 0 0 0 0
      0 0 0 0 0 0 0 0 0 0 0 0 0 0 0 0 0 0 0 0 0 0 0 0 0 0 0 0 0 0 0 0 0 0 0
      0 0 0 0 0 0 0 0 0 0 0 0 0 0 0 0 0 0 0 0 0 0 0 0 0 0 0 0 0 0 0 0 0 0 0
      0 0 0 0 0 0 0 0 0 0 0 0 0 0 0 0 0 0 0 0 0 0 0 0 0 0 0 0 0 0 0 0 0 0 0
      0 0 1 1 1 1 1 0 0 0 1 1 0 0 0 0 1 0 1 1 0 0 1 1 1 0 0 0 1 1 1 1 0 0 0
      0 0 1 1 0 0 0 0 0 0 0 1 0 1 0 0 0 1 0 1 0 0 1 0 1 1 0 0 1 0 0 1 1 0 0
      0 0 0 1 1 1 0 0 0 0 0 1 0 1 0 0 0 1 0 1 0 0 1 0 0 1 0 0 1 0 0 0 1 0 0
      0 0 0 0 0 1 1 0 0 0 0 1 0 1 0 0 0 1 0 1 0 0 1 0 0 0 0 0 1 0 0 1 1 0 0
      0 0 0 0 0 0 1 0 0 0 0 1 0 1 0 0 0 1 1 1 0 0 1 1 0 0 0 0 1 1 1 1 0 0 0
      0 0 0 0 1 1 1 0 0 0 0 1 0 1 0 0 0 1 1 0 0 0 1 0 0 0 0 0 1 0 1 1 0 0 0
      0 0 0 1 1 0 0 0 0 0 0 1 0 1 0 0 0 1 0 0 0 0 1 0 0 0 0 0 1 0 0 1 1 0 0
      1 1 1 0 0 0 0 0 0 0 0 1 1 1 0 0 0 1 0 0 0 0 1 0 1 0 0 0 1 0 0 0 1 1 0
      0 0 0 0 0 0 0 0 0 0 0 0 0 0 0 0 0 1 0 0 0 0 1 1 1 0 0 0 1 0 0 0 0 1 0
      0 0 0 0 0 0 0 0 0 0 0 0 0 0 0 0 0 0 0 0 0 0 0 0 0 0 0 0 0 0 0 0 0 0 0
      0 0 0 0 0 0 0 0 0 0 0 0 0 0 0 0 0 0 0 0 0 0 0 0 0 0 0 0 0 0 0 0 0 0 0
      0 0 0 0 0 0 0 0 0 0 0 0 0 0 0 0 0 0 0 0 0 0 0 0 0 0 0 0 0 0 0 0 0 0 0
      0 0 0 0 0 0 0 0 0 0 0 0 0 0 0 0 0 0 0 0 0 0 0 0 0 0 0 0 0 0 0 0 0 0 0
      0 0 0 0 0 0 0 0 0 0 0 0 0 0 0 0 0 0 0 0 0 0 0 0 0 0 0 0 0 0 0 0 0 0 0
      0 0 0 1 1 1 1 1 1 1 1 1 0 0 0 0 0 0 0 0 0 0 0 1 1 1 1 1 0 0 0 0 1 1 0
      0 0 0 0 0 0 1 0 0 0 0 0 1 0 0 0 0 0 0 0 0 0 1 1 0 0 0 1 1 0 0 1 1 0 0
      0 0 0 0 0 0 1 0 0 0 0 0 1 1 0 0 0 0 0 0 0 0 1 0 0 0 0 0 1 1 0 1 0 0 0
      0 0 0 0 0 0 1 0 0 0 0 0 0 1 0 0 0 0 0 0 0 0 1 0 0 0 0 0 0 1 1 0 0 0 0
      0 0 0 0 0 0 1 0 0 0 0 0 0 1 0 0 0 0 0 0 0 0 1 0 0 0 0 0 0 1 1 0 0 0 0
      0 0 0 0 0 0 1 0 0 0 0 0 0 1 0 0 0 0 0 0 0 0 1 0 0 0 0 0 1 1 1 1 0 0 0
      0 0 0 0 0 0 1 0 0 0 0 0 0 1 0 0 0 0 0 0 0 1 1 0 0 0 0 1 1 0 0 1 1 0 0
      0 0 0 0 0 0 1 0 0 0 0 0 0 1 11 11 0 0 0 0 1 1 0 0 0 0 0 1 0 0 0 0 1 1 0
      0 0 0 0 0 0 1 0 0 0 0 0 0 0 0 11 11 11 11 11 1 0 0 0 0 0 1 1 0 0 0 0 0 0 0
      0 0 0 0 0 0 0 0 0 0 0 0 0 0 0 0 0 0 0 0 0 0 0 0 0 0 0 0 0 0 0 0 0 0 0
      0 0 0 0 0 0 0 0 0 0 0 0 0 0 0 0 0 0 0 0 0 0 0 0 0 0 0 0 0 0 0 0 0 0 0
      0 0 0 0 0 0 0 0 0 0 0 0 0 0 0 0 0 0 0 0 0 0 0 0 0 0 0 0 0 0 0 0 0 0 0
      0 0 0 0 0 0 0 0 0 0 0 0 0 0 0 0 0 0 0 0 0 0 0 0 0 0 0 0 0 0 0 0 0 0 0
      0 0 0 0 0 0 0 0 0 0 0 0 0 0 0 0 0 0 0 0 0 0 0 0 0 0 0 0 0 0 0 0 0 0 0
      0 0 0 0 0 0 0 0 0 0 0 0 0 0 0 0 0 0 0 0 0 0 0 0 0 0 0 0 0 0 0 0 0 0 0
      0 0 0 0 0 0 0 0 0 0 0 0 0 0 0 0 0 0 0 0 0 0 0 0 0 0 0 0 0 0 0 0 0 0 0
      0 0 0 0 0 0 0 0 0 0 0 0 0 0 0 0 0 0 0 0 0 0 0 0 0 0 0 0 0 0 0 0 0 0 0
      )
    )
    (tilemap
      (z-pos 100)
      (solid #f)
      (name "Foreground")
      (width 35)
      (height 35)
      (tiles
      0 0 0 0 0 0 0 0 0 0 0 0 0 0 0 0 0 0 0 0 0 0 0 0 0 0 0 0 0 0 0 0 0 0 0
      0 0 0 0 0 0 0 0 0 0 0 0 0 0 0 0 0 0 0 0 0 0 0 0 0 0 0 0 0 0 0 0 0 0 0
      0 0 0 0 0 0 0 0 0 0 0 0 0 0 0 0 0 0 0 0 0 0 0 0 0 0 0 0 0 0 0 0 0 0 0
      0 0 0 0 0 0 0 0 0 0 0 0 0 0 0 0 0 0 0 0 0 0 0 0 0 0 0 0 0 0 0 0 0 0 0
      0 0 0 0 0 0 0 0 0 0 0 0 0 0 0 0 0 0 0 0 0 0 0 0 0 0 0 0 0 0 0 0 0 0 0
      0 0 0 0 0 0 0 0 0 0 0 0 0 0 0 0 0 0 0 0 0 0 0 0 0 0 0 0 0 0 0 0 0 0 0
      0 0 0 0 0 0 0 0 0 0 0 0 0 0 0 0 0 0 0 0 0 0 0 0 0 0 0 0 0 0 0 0 0 0 0
      0 0 0 0 0 0 0 0 0 0 0 0 0 0 0 0 0 0 0 0 0 0 0 0 0 0 0 0 0 0 0 0 0 0 0
      0 0 0 0 0 0 0 0 0 0 0 0 0 0 0 0 0 0 0 0 0 0 0 0 0 0 0 0 0 0 0 0 0 0 0
      0 0 0 0 0 0 0 0 0 0 0 0 0 0 0 0 0 0 0 0 0 0 0 0 0 0 0 0 0 0 0 0 0 0 0
      0 0 0 0 0 0 0 0 0 0 0 0 0 0 0 0 0 0 0 0 0 0 0 0 0 0 0 0 0 0 0 0 0 0 0
      0 0 0 0 0 0 0 0 0 0 0 0 0 0 0 0 0 0 0 0 0 0 0 0 0 0 0 0 0 0 0 0 0 0 0
      0 0 0 0 0 0 0 0 0 0 0 0 0 0 0 0 0 0 0 0 0 0 0 0 0 0 0 0 0 0 0 0 0 0 0
      0 0 0 0 0 0 0 0 0 0 0 0 0 0 0 0 0 0 0 0 0 0 0 0 0 0 0 0 0 0 0 0 0 0 0
      0 0 0 0 0 0 0 0 0 0 0 0 0 0 0 0 0 0 0 0 0 0 0 0 0 0 0 0 0 0 0 0 0 0 0
      0 0 0 0 0 0 0 0 0 0 0 0 0 0 0 0 0 0 0 0 0 0 0 0 0 0 0 0 0 0 0 0 0 0 0
      0 0 0 0 0 0 0 0 0 0 0 0 0 0 0 0 0 0 0 0 0 0 0 0 0 0 0 0 0 0 0 0 0 0 0
      0 0 0 0 0 0 0 0 0 0 0 0 0 0 0 0 0 0 0 0 0 0 0 0 0 0 0 0 0 0 0 0 0 0 0
      0 0 0 0 0 0 0 0 0 0 0 0 0 0 0 0 0 0 0 0 0 0 0 0 0 0 0 0 0 0 0 0 0 0 0
      0 0 0 0 0 0 0 0 0 0 0 0 0 0 0 0 0 0 0 0 0 0 0 0 0 0 0 0 0 0 0 0 0 0 0
      0 0 0 0 0 0 0 0 0 0 0 0 0 0 0 0 0 0 0 0 0 0 0 0 0 0 0 0 0 0 0 0 0 0 0
      0 0 0 0 0 0 0 0 0 0 0 0 0 0 0 0 0 0 0 0 0 0 0 0 0 0 0 0 0 0 0 0 0 0 0
      0 0 0 0 0 0 0 0 0 0 0 0 0 0 0 0 0 0 0 0 0 0 0 0 0 0 0 0 0 0 0 0 0 0 0
      0 0 0 0 0 0 0 0 0 0 0 0 0 0 0 0 0 0 0 0 0 0 0 0 0 0 0 0 0 0 0 0 0 0 0
      0 0 0 0 0 0 0 0 0 0 0 0 0 0 0 0 0 0 0 0 0 0 0 0 0 0 0 0 0 0 0 0 0 0 0
      0 0 0 0 0 0 0 0 0 0 0 0 0 0 1 1 0 0 0 0 0 0 0 0 0 0 0 0 0 0 0 0 0 0 0
      0 0 0 0 0 0 0 0 0 0 0 0 0 0 0 1 1 1 1 1 0 0 0 0 0 0 0 0 0 0 0 0 0 0 0
      0 0 0 0 0 0 0 0 0 0 0 0 0 0 0 0 0 0 0 0 0 0 0 0 0 0 0 0 0 0 0 0 0 0 0
      0 0 0 0 0 0 0 0 0 0 0 0 0 0 0 0 0 0 0 0 0 0 0 0 0 0 0 0 0 0 0 0 0 0 0
      0 0 0 0 0 0 0 0 0 0 0 0 0 0 0 0 0 0 0 0 0 0 0 0 0 0 0 0 0 0 0 0 0 0 0
      0 0 0 0 0 0 0 0 0 0 0 0 0 0 0 0 0 0 0 0 0 0 0 0 0 0 0 0 0 0 0 0 0 0 0
      0 0 0 0 0 0 0 0 0 0 0 0 0 0 0 0 0 0 0 0 0 0 0 0 0 0 0 0 0 0 0 0 0 0 0
      0 0 0 0 0 0 0 0 0 0 0 0 0 0 0 0 0 0 0 0 0 0 0 0 0 0 0 0 0 0 0 0 0 0 0
      0 0 0 0 0 0 0 0 0 0 0 0 0 0 0 0 0 0 0 0 0 0 0 0 0 0 0 0 0 0 0 0 0 0 0
      0 0 0 0 0 0 0 0 0 0 0 0 0 0 0 0 0 0 0 0 0 0 0 0 0 0 0 0 0 0 0 0 0 0 0
      )
    )
  )
)
