(supertux-level
  (version 2)
  (name (_ "72-bit totem required (hard)"))
  (author "hume") (license "GPL 2+ / CC-by-sa 3.0")
  (sector
    (name "main")
    (music "music/chipdisko.ogg")
    (ambient-light 1 1 1)
    (background
      (speed 0.5)
      (image-top "images/background/arctis_top.jpg")
      (image "images/background/arctis.jpg")
      (image-bottom "images/background/arctis_bottom.jpg")
    )
    (camera
      (mode "normal")
    )
    (door
      (sector "main")
      (spawnpoint "indoor")
      (x 640)
      (y 736)
    )
    (infoblock
      (message (_ "!images/creatures/totem/walking3.png
 1-bit totem
t+
!images/creatures/totem/walking3.png
 1-bit totem
t|
t\\/
!images/creatures/totem/stacked.png
!images/creatures/totem/walking3.png
 2-bit totem
tWhile you can't jump over the hole, try building higher totems."))
      (x 768)
      (y 3680)
    )
    (climbable
      (width 32)
      (height 3488)
      (x 32)
      (y 160)
    )
(dispenser
      (x 128)
      (y 3328)
      (badguy "totem")
      (cycle 2.5))
    (scripttrigger
      (script "import(\"levels/hume/defualt.nut\")
sector.Tux.trigger_sequence(\"endsequence\")
unlock_archivement(\"i\")")
      (button #f)
      (width 32)
      (height 320)
      (x 640)
      (y 0)
    )
    (spawnpoint
      (name "main")
      (x 0)
      (y 320)
    )
    (spawnpoint
      (name "indoor")
      (x 128)
      (y 640)
    )
    (switch
      (script "platforma.goto_node(1);wait(1);platforma.goto_node(0)")
      (x 0)
      (y 3680)
      (sprite "images/objects/switch/switch.sprite")
    )
    (tilemap
      (z-pos 0)
      (solid #t)
      (name "platforma")
      (path
        (node
          (x 96)
          (y 3648)
          (time 0.5)
        )
        (node
          (x 96)
          (y 3776)
        )
      )
      (width 3)
      (height 1)
      (tiles
      48 48 48
      )
    )
    (tilemap
      (z-pos 0)
      (solid #t)
      (width 25)
      (height 119)
      (tiles
      0 0 0 0 0 0 0 0 0 0 0 0 0 0 0 0 0 0 0 0 0 0 0 0 132
      0 0 0 0 0 0 0 0 0 0 0 0 0 0 0 0 0 0 0 0 0 0 0 0 132
      0 0 0 0 0 0 0 0 0 0 0 0 0 0 0 0 0 0 0 0 0 0 0 0 132
      0 0 0 0 0 0 0 0 0 0 0 0 0 0 0 0 0 0 0 0 0 0 0 0 132
      0 1569 0 0 0 0 0 0 0 0 0 0 0 0 0 0 0 0 0 0 130 0 0 0 132
      0 1570 0 0 0 0 102 0 0 0 0 0 0 0 0 0 0 0 0 0 129 0 0 0 132
      0 1570 0 0 0 0 0 0 0 0 0 0 0 0 0 0 0 0 0 0 129 0 0 0 132
      0 1570 0 0 0 0 0 0 0 0 0 0 0 0 0 0 0 0 0 0 129 0 0 0 132
      0 1570 0 1731 1732 1628 1629 0 0 0 0 0 0 0 0 0 0 0 0 0 129 0 0 0 132
      0 1572 0 1733 1734 1630 1631 0 0 0 0 0 0 0 0 0 0 0 0 0 129 0 0 0 132
      0 1570 48 2156 2156 2156 48 0 0 0 0 0 0 0 0 0 0 0 0 0 2155 2156 2156 2156 2157
      0 1570 48 0 0 0 48 0 0 0 0 0 0 0 0 0 0 0 0 0 0 0 0 0 0
      0 1570 48 0 0 0 48 0 0 0 0 0 0 0 0 0 0 0 0 0 0 0 0 0 0
      0 1570 48 0 0 0 48 0 0 0 0 0 0 0 0 0 0 0 0 0 0 0 0 0 0
      0 1572 48 0 0 0 48 0 0 0 0 0 0 0 0 0 0 0 0 0 0 0 0 0 0
      0 1570 48 0 1727 1728 48 0 0 0 0 0 0 0 0 0 0 0 0 0 0 0 0 0 0
      0 1570 48 0 1729 1730 48 0 0 0 0 0 0 0 0 0 0 0 0 0 0 0 0 0 0
      0 1570 48 0 1760 1761 48 0 0 0 0 0 0 0 0 0 0 0 0 0 0 0 0 0 0
      0 1570 48 0 0 0 48 0 0 0 0 0 0 0 0 0 0 0 0 0 0 0 0 0 0
      0 1572 48 0 0 0 48 0 0 0 0 0 0 0 0 0 0 0 0 0 0 0 0 0 0
      0 1570 48 0 0 0 48 0 0 0 0 0 0 0 0 0 0 0 0 0 0 0 0 0 0
      0 1570 48 0 0 0 48 0 0 0 0 0 0 0 0 0 0 0 0 0 0 0 0 0 0
      0 1570 48 0 0 0 48 0 0 0 0 0 0 0 0 0 0 0 0 0 0 0 0 0 0
      0 1570 48 0 0 0 48 0 0 0 0 0 0 0 0 0 0 0 0 0 0 0 0 0 0
      0 1572 48 0 0 0 48 0 0 0 0 0 0 0 0 0 0 0 0 0 0 0 0 1727 1728
      0 1570 48 0 0 0 48 0 0 0 0 0 0 0 0 0 0 0 0 0 0 0 0 1729 1730
      0 1570 48 0 0 0 48 0 0 0 0 0 0 0 0 0 0 0 0 0 2155 2156 2156 2156 2157
      0 1570 48 0 0 0 48 0 0 0 0 0 0 0 0 0 0 0 0 0 0 0 0 0 0
      0 1570 48 0 0 0 48 0 0 0 0 0 0 0 0 0 0 0 0 0 0 0 0 0 0
      0 1572 48 0 0 0 48 0 0 0 0 0 0 0 0 0 0 0 0 0 0 0 0 0 0
      0 1570 48 0 0 0 48 0 0 0 0 0 0 0 0 0 0 0 0 0 0 0 0 0 0
      0 1570 48 0 0 0 48 0 0 0 0 0 0 0 0 0 0 0 0 0 0 0 0 0 0
      0 1570 48 0 0 0 48 0 0 0 0 0 0 0 0 0 0 0 0 0 0 0 0 0 0
      0 1570 48 0 0 0 48 0 0 0 0 0 0 0 0 0 0 0 0 0 0 0 0 0 0
      0 1572 48 0 0 0 48 0 0 0 0 0 0 0 0 0 0 0 0 0 0 0 0 0 0
      0 1570 48 0 0 0 48 0 0 0 0 0 0 0 0 0 0 0 0 0 0 0 0 0 0
      0 1570 48 0 0 0 48 0 0 0 0 0 0 0 0 0 0 0 0 0 0 0 0 0 0
      0 1570 48 0 0 0 48 0 0 0 0 0 0 0 0 0 0 0 0 0 0 0 0 0 0
      0 1570 48 0 0 0 48 0 0 0 0 0 0 0 0 0 0 0 0 0 0 0 0 0 0
      0 1572 48 0 0 0 48 0 0 0 0 0 0 0 0 0 0 0 0 0 0 0 0 0 0
      0 1570 48 0 0 0 48 0 0 0 0 0 0 0 0 0 0 0 0 0 0 0 0 0 0
      0 1570 48 0 0 0 48 0 0 0 0 0 0 0 0 0 0 0 0 0 0 0 0 0 0
      0 1570 48 0 0 0 48 0 0 0 0 0 0 0 0 0 0 0 0 0 0 0 0 0 0
      0 1570 48 0 0 0 48 0 0 0 0 0 0 0 0 0 0 0 0 0 0 0 0 0 0
      0 1572 48 0 0 0 48 0 0 0 0 0 0 0 0 0 0 0 0 0 0 0 0 0 0
      0 1570 48 0 0 0 48 0 0 0 0 0 0 0 0 0 0 0 0 0 0 0 0 0 0
      0 1570 48 0 0 0 48 0 0 0 0 0 0 0 0 0 0 0 0 0 0 0 0 0 0
      0 1570 48 0 0 0 48 0 0 0 0 0 0 0 0 0 0 0 0 0 0 0 0 0 0
      0 1570 48 0 0 0 48 0 0 0 0 0 0 0 0 0 0 0 0 0 0 0 0 0 0
      0 1572 48 0 0 0 48 0 0 0 0 0 0 0 0 0 0 0 0 0 0 0 0 0 0
      0 1570 48 0 0 0 48 0 0 0 0 0 0 0 0 0 0 0 0 0 0 0 0 0 0
      0 1570 48 0 0 0 48 0 0 0 0 0 0 0 0 0 0 0 0 0 0 0 0 0 0
      0 1570 48 0 0 0 48 0 0 0 0 0 0 0 0 0 0 0 0 0 0 0 0 0 0
      0 1570 48 0 0 0 48 0 0 0 0 0 0 0 0 0 0 0 0 0 0 0 0 0 0
      0 1572 48 0 0 0 48 0 0 0 0 0 0 0 0 0 0 0 0 0 0 0 0 0 0
      0 1570 48 0 0 0 48 0 0 0 0 0 0 0 0 0 0 0 0 0 0 0 0 0 0
      0 1570 48 0 0 0 48 0 0 0 0 0 0 0 0 0 0 0 0 0 0 0 0 0 0
      0 1570 48 0 0 0 48 0 0 0 0 0 0 0 0 0 0 0 0 0 0 0 0 0 0
      0 1570 48 0 0 0 48 0 0 0 0 0 0 0 0 0 0 0 0 0 0 0 0 0 0
      0 1572 48 0 0 0 48 0 0 0 0 0 0 0 0 0 0 0 0 0 0 0 0 0 0
      0 1570 48 0 0 0 48 0 0 0 0 0 0 0 0 0 0 0 0 0 0 0 0 0 0
      0 1570 48 0 0 0 48 0 0 0 0 0 0 0 0 0 0 0 0 0 0 0 0 0 0
      0 1570 48 0 0 0 48 0 0 0 0 0 0 0 0 0 0 0 0 0 0 0 0 0 0
      0 1570 48 0 0 0 48 0 0 0 0 0 0 0 0 0 0 0 0 0 0 0 0 0 0
      0 1572 48 0 0 0 48 0 0 0 0 0 0 0 0 0 0 0 0 0 0 0 0 0 0
      0 1570 48 0 0 0 48 0 0 0 0 0 0 0 0 0 0 0 0 0 0 0 0 0 0
      0 1570 48 0 0 0 48 0 0 0 0 0 0 0 0 0 0 0 0 0 0 0 0 0 0
      0 1570 48 0 0 0 48 0 0 0 0 0 0 0 0 0 0 0 0 0 0 0 0 0 0
      0 1570 48 0 0 0 48 0 0 0 0 0 0 0 0 0 0 0 0 0 0 0 0 0 0
      0 1572 48 0 0 0 48 0 0 0 0 0 0 0 0 0 0 0 0 0 0 0 0 0 0
      0 1570 48 0 0 0 48 0 0 0 0 0 0 0 0 0 0 0 0 0 0 0 0 0 0
      0 1570 48 0 0 0 48 0 0 0 0 0 0 0 0 0 0 0 0 0 0 0 0 0 0
      0 1570 48 0 0 0 48 0 0 0 0 0 0 0 0 0 0 0 0 0 0 0 0 0 0
      0 1570 48 0 0 0 48 0 0 0 0 0 0 0 0 0 0 0 0 0 0 0 0 0 0
      0 1572 48 0 0 0 48 0 0 0 0 0 0 0 0 0 0 0 0 0 0 0 0 0 0
      0 1570 48 0 0 0 48 0 0 0 0 0 0 0 0 0 0 0 0 0 0 0 0 0 0
      0 1570 48 0 0 0 48 0 0 0 0 0 0 0 0 0 0 0 0 0 0 0 0 0 0
      0 1570 48 0 0 0 48 0 0 0 0 0 0 0 0 0 0 0 0 0 0 0 0 0 0
      0 1570 48 0 0 0 48 0 0 0 0 0 0 0 0 0 0 0 0 0 0 0 0 0 0
      0 1572 48 0 0 0 48 0 0 0 0 0 0 0 0 0 0 0 0 0 0 0 0 0 0
      0 1570 48 0 0 0 48 0 0 0 0 0 0 0 0 0 0 0 0 0 0 0 0 0 0
      0 1570 48 0 0 0 48 0 0 0 0 0 0 0 0 0 0 0 0 0 0 0 0 0 0
      0 1570 48 0 0 0 48 0 0 0 0 0 0 0 0 0 0 0 0 0 0 0 0 0 0
      0 1570 48 0 0 0 48 0 0 0 0 0 0 0 0 0 0 0 0 0 0 0 0 0 0
      0 1572 48 0 0 0 48 0 0 0 0 0 0 0 0 0 0 0 0 0 0 0 0 0 0
      0 1570 48 0 0 0 48 0 0 0 0 0 0 0 0 0 0 0 0 0 0 0 0 0 0
      0 1570 48 0 0 0 48 0 0 0 0 0 0 0 0 0 0 0 0 0 0 0 0 0 0
      0 1570 48 0 0 0 48 0 0 0 0 0 0 0 0 0 0 0 0 0 0 0 0 0 0
      0 1570 48 0 0 0 48 0 0 0 0 0 0 0 0 0 0 0 0 0 0 0 0 0 0
      0 1572 48 0 0 0 48 0 0 0 0 0 0 0 0 0 0 0 0 0 0 0 0 0 0
      0 1570 48 0 0 0 48 0 0 0 0 0 0 0 0 0 0 0 0 0 0 0 0 0 0
      0 1570 48 0 0 0 48 0 0 0 0 0 0 0 0 0 0 0 0 0 0 0 0 0 0
      0 1570 48 0 0 0 48 0 0 0 0 0 0 0 0 0 0 0 0 0 0 0 0 0 0
      0 1570 48 0 0 0 48 0 0 0 0 0 0 0 0 0 0 0 0 0 0 0 0 0 0
      0 1572 48 0 0 102 48 0 0 0 0 0 0 0 0 0 0 0 0 0 0 0 0 0 0
      0 1570 48 0 0 0 48 0 0 0 0 0 0 0 0 0 0 0 0 0 0 0 0 0 0
      0 1570 48 0 0 0 48 0 0 0 0 0 0 0 0 0 0 0 0 0 0 0 0 0 0
      0 1570 48 0 0 0 48 0 0 0 0 0 0 0 0 0 0 0 0 0 0 0 0 0 0
      0 1570 48 0 0 0 48 0 0 0 0 0 0 0 0 0 0 0 0 0 0 0 0 0 0
      0 1572 48 0 0 0 0 0 0 0 0 0 0 0 0 0 0 0 0 0 0 0 0 0 0
      0 1570 48 102 0 0 0 0 0 0 0 0 0 0 0 0 0 0 0 0 0 0 0 0 0
      0 1570 48 0 0 0 0 0 0 0 0 0 0 0 0 0 0 0 0 0 0 0 0 0 0
      0 1570 48 0 0 0 0 0 0 0 0 0 0 0 0 0 0 0 0 0 0 0 0 0 0
      0 1570 48 0 0 0 0 0 0 0 0 0 0 0 0 0 0 0 0 0 0 0 0 0 0
      0 1572 48 48 0 0 0 0 0 0 0 0 0 0 0 0 0 0 0 0 0 0 0 0 0
      0 1570 48 0 0 0 48 0 0 0 0 0 0 0 0 0 0 0 0 0 0 0 0 0 0
      0 1570 48 0 0 0 48 0 0 0 0 0 0 0 0 0 0 0 0 0 0 0 0 0 0
      0 1570 48 0 0 0 48 0 0 0 0 0 0 0 0 0 0 0 0 0 0 0 0 0 0
      0 1570 48 0 0 0 48 0 0 0 0 0 0 0 0 0 0 0 0 0 0 0 0 0 0
      0 1572 48 0 0 0 48 0 0 0 0 0 0 0 0 0 0 0 0 0 0 0 0 0 0
      0 1570 48 0 0 0 48 0 0 0 0 0 0 0 0 0 0 0 0 0 0 0 0 0 0
      0 1570 48 0 0 0 48 0 0 0 0 0 0 0 0 0 0 0 0 0 0 0 0 0 0
      0 1570 48 0 0 0 48 0 0 0 0 0 0 0 0 0 0 0 0 0 0 0 0 0 0
      0 1570 48 0 0 0 48 0 0 0 0 0 0 0 0 0 0 0 0 0 0 0 0 0 0
      0 48 48 0 0 0 48 0 0 0 0 0 0 0 0 0 0 0 0 0 0 0 0 0 0
      0 0 0 0 0 0 0 0 0 0 0 0 0 0 0 0 0 0 0 0 0 0 0 0 0
      0 1620 1621 1731 1732 0 0 0 0 0 0 0 1608 1609 0 0 0 0 0 0 0 0 0 0 0
      0 1622 1623 1733 1734 0 0 0 0 0 0 0 1610 1611 0 0 0 0 0 0 0 0 0 0 0
      48 48 48 48 48 48 48 48 48 48 48 48 48 48 48 48 48 48 48 48 48 48 48 48 48
      )
    )
  )
)
