(supertux-level
  (version 2)
  (name (_ "world 1"))
  (author "Basti")
  (license "GPL 2+ / CC-by-sa 3.0")
  (target-time 0)
  (sector
    (name "main")
    (ambient-light 1 1 1)
    (camera
      (mode "normal")
    )
    (tilemap
      (solid #t)
      (z-pos 0)
      (name "Interactive")
      (width 75)
      (height 35)
      (tiles
      19 19 19 19 19 19 19 19 19 19 19 17 9 9 9 9 9 9 9 9 9 9 9 9 9 9 9 15 19 19 19 19 19 19 19 19 19 19 19 19 19 19 19 19 19 19 19 19 19 19 19 19 19 19 19 19 19 19 19 19 19 19 19 19 19 19 19 19 19 17 9 9 9 9 9
      19 19 19 19 19 19 19 19 19 19 19 17 9 9 9 9 9 9 9 9 9 9 9 9 9 9 9 15 19 19 19 19 19 19 19 19 19 19 19 19 19 19 19 19 19 19 19 19 19 19 19 19 19 19 19 19 19 19 19 19 19 19 19 19 19 19 19 19 19 17 9 9 9 9 9
      19 19 19 58 19 19 19 19 19 19 19 17 9 9 9 9 9 9 9 9 9 9 9 9 9 9 9 15 19 19 19 19 19 19 19 19 19 19 19 19 19 19 19 19 19 19 19 19 19 19 19 19 19 19 19 19 19 19 19 19 19 19 19 19 19 19 19 19 19 17 9 9 9 9 9
      19 19 19 59 19 19 19 19 19 19 19 17 9 9 9 9 9 9 9 9 9 9 9 9 9 9 11 22 19 19 19 19 19 19 19 19 19 19 19 24 25 26 19 19 19 19 19 19 19 19 19 19 19 19 19 19 19 19 19 19 19 19 19 19 19 19 19 19 19 17 9 9 9 9 9
      19 60 19 47 19 60 19 19 19 19 19 17 9 9 9 9 9 9 9 9 9 9 9 9 9 9 15 19 19 19 19 19 19 19 19 19 19 19 19 30 36 34 26 19 19 19 19 19 19 58 19 19 19 19 19 19 19 19 19 19 19 19 19 19 19 19 19 19 19 17 9 9 9 9 9
      19 19 19 47 19 19 19 19 19 19 20 13 9 9 9 9 9 9 9 9 9 9 9 9 9 9 15 19 19 19 19 19 19 19 19 19 19 19 19 19 30 35 28 19 19 19 19 19 19 59 19 19 19 19 19 19 19 19 19 19 19 19 19 19 19 19 20 18 18 13 9 9 9 9 9
      19 19 19 47 19 19 19 19 19 19 17 9 9 9 9 9 9 9 9 9 9 9 9 9 9 9 15 19 19 19 19 19 19 24 26 19 19 19 19 19 19 19 19 48 40 40 40 40 40 42 19 19 19 19 19 19 19 19 19 19 19 19 19 19 19 19 23 16 16 12 9 9 9 9 9
      19 19 19 47 19 19 19 19 19 19 17 9 9 9 9 9 9 9 9 9 9 11 16 16 12 11 22 19 19 19 19 19 19 31 27 19 19 19 19 19 19 19 19 47 19 19 19 19 19 19 19 19 19 19 19 19 19 19 19 19 19 19 19 19 19 19 19 19 19 17 9 9 9 9 9
      19 19 19 47 19 19 19 19 19 19 17 9 9 9 9 9 9 9 9 9 11 22 19 19 17 14 18 21 19 19 19 19 19 30 28 19 19 19 19 19 19 19 19 47 19 19 19 19 19 19 19 19 19 19 19 19 19 19 19 19 19 19 19 19 19 19 19 19 19 17 9 9 9 9 9
      19 19 19 47 19 19 19 19 19 20 13 9 9 9 9 9 9 9 9 9 15 49 50 51 23 16 16 22 19 19 19 19 19 19 19 19 19 19 19 19 19 19 19 47 19 19 19 19 19 19 19 19 19 19 19 19 19 19 19 19 19 19 19 19 19 19 19 19 19 17 9 9 9 9 9
      19 19 19 37 40 39 19 19 20 13 9 9 9 9 9 9 9 9 9 9 15 52 53 54 70 60 19 19 19 19 19 19 19 19 19 19 19 19 19 19 19 19 19 47 19 19 19 19 19 19 19 19 19 19 19 19 19 19 19 20 18 18 18 18 18 18 18 18 18 13 9 9 9 9 9
      19 19 19 19 19 47 19 19 17 9 9 9 9 9 9 9 9 9 9 9 15 55 56 57 61 67 19 19 19 19 19 19 19 19 19 19 19 19 19 19 19 19 19 47 19 19 19 19 19 19 19 19 19 19 19 19 19 19 19 17 9 9 9 9 9 9 9 9 9 9 9 9 9 9 9
      19 19 19 19 19 47 19 19 17 9 9 9 9 9 9 9 9 9 9 11 22 60 19 60 47 60 19 19 19 19 19 19 19 19 19 19 19 19 19 19 19 19 19 47 19 19 19 19 19 19 19 19 19 19 19 19 19 19 19 17 9 9 9 9 9 9 9 9 9 9 9 9 9 9 9
      19 19 19 19 19 47 19 19 17 9 9 9 9 9 9 9 9 9 9 15 19 19 19 19 47 19 19 19 19 19 19 19 19 19 19 19 19 19 19 19 19 19 19 47 19 19 19 19 19 19 19 19 19 19 19 19 19 19 19 17 9 9 9 9 9 9 9 9 9 9 9 9 9 9 9
      19 19 19 19 19 47 19 19 17 9 9 9 9 9 9 9 9 9 9 15 19 19 19 19 47 19 19 19 19 19 19 19 19 19 19 19 19 19 19 19 19 19 19 47 19 19 19 19 19 19 19 19 19 19 19 19 19 19 19 17 9 9 9 9 9 9 9 9 9 9 9 9 9 9 9
      19 19 19 19 19 47 19 19 17 9 9 9 9 9 9 9 9 9 9 15 19 19 19 19 41 40 40 40 40 40 40 40 40 40 40 40 40 40 40 40 40 43 40 42 19 19 19 19 19 19 19 19 19 19 19 19 19 19 19 17 9 9 9 9 9 9 9 9 9 9 9 9 9 9 9
      19 19 19 19 19 47 19 19 23 16 12 9 9 9 9 9 9 11 16 22 19 19 19 19 47 19 19 19 19 19 19 19 19 19 19 19 19 19 19 19 19 47 19 19 19 19 19 19 19 19 19 19 19 19 19 19 19 19 19 17 9 9 9 9 9 9 9 9 9 9 9 9 9 9 9
      19 19 19 19 19 47 19 19 19 19 23 12 9 9 9 11 16 22 19 19 19 19 19 19 47 19 19 19 19 19 19 19 19 19 19 19 19 19 19 19 19 47 19 19 19 19 19 19 19 19 19 19 19 19 19 19 19 19 19 17 9 9 9 9 9 9 9 9 9 9 9 9 9 9 9
      19 19 19 19 19 37 40 39 19 19 19 23 16 16 16 22 19 19 19 19 19 19 19 19 47 19 19 19 19 19 19 19 19 19 19 19 19 19 19 19 19 47 19 19 19 19 19 19 19 19 19 19 19 19 19 19 19 19 19 17 9 9 9 9 9 9 9 9 9 9 9 9 9 9 9
      19 19 19 19 19 19 19 47 19 19 19 19 19 19 19 19 19 19 19 19 19 19 19 19 47 19 19 19 19 19 19 19 19 19 19 19 19 19 19 19 19 37 40 40 40 40 40 40 40 40 40 40 40 40 40 71 19 19 19 17 9 9 9 9 9 9 9 9 9 9 9 9 9 9 9
      19 19 19 19 19 19 19 47 19 19 19 19 19 19 19 19 19 19 19 19 19 19 19 19 47 19 19 19 19 19 19 19 19 19 19 19 19 19 19 19 19 19 19 19 19 19 19 19 19 19 19 19 19 19 19 19 19 19 19 23 16 16 16 16 16 16 16 16 12 9 9 9 9 9 9
      19 19 19 19 19 19 19 37 40 39 19 19 19 19 19 19 19 19 19 19 19 19 19 19 47 19 19 19 19 19 19 19 19 19 19 19 19 19 19 19 19 19 19 19 19 19 19 19 19 19 19 19 19 19 19 19 19 19 19 19 19 19 19 19 19 19 19 19 17 9 9 9 9 9 9
      19 19 19 19 19 19 19 19 19 47 19 19 19 19 19 19 19 19 19 19 19 19 19 19 47 19 19 19 19 19 19 19 19 19 19 19 19 19 19 19 19 19 19 19 19 19 19 19 19 19 19 19 19 19 19 19 19 19 19 19 19 19 19 19 19 19 19 19 17 9 9 9 9 9 9
      19 19 19 19 19 19 19 19 19 47 19 19 19 19 19 19 48 40 40 40 40 39 19 19 47 19 19 19 19 19 19 19 19 19 19 19 19 19 19 19 19 19 19 19 19 19 19 19 19 19 19 19 19 19 19 19 19 19 19 19 19 19 19 19 19 19 19 19 17 9 9 9 9 9 9
      19 19 19 19 19 19 19 19 19 47 19 19 19 19 19 48 42 19 19 19 19 47 19 19 47 19 19 19 19 19 19 19 19 19 19 19 19 19 19 19 19 19 19 19 19 19 19 19 19 19 19 19 19 19 19 19 19 19 20 18 18 18 18 18 18 18 18 18 13 9 9 9 9 9 9
      19 19 19 19 19 19 19 19 19 47 19 19 19 19 19 47 19 19 19 19 19 37 40 43 42 19 19 19 19 19 19 19 19 19 19 19 19 19 19 19 19 19 19 19 19 19 19 19 19 19 19 19 19 19 20 18 18 18 13 9 9 9 9 9 9 9 9 9 9 9 9 9 9 9 9
      19 19 19 19 19 19 19 19 19 47 19 19 19 19 19 47 19 19 19 19 19 19 19 47 19 19 19 19 19 19 19 19 19 19 19 19 19 19 19 19 19 19 19 19 19 19 19 19 19 19 19 19 19 19 17 9 9 9 9 9 9 9 9 9 9 9 9 9 9 9 9 9 9 9 9
      19 19 19 19 19 19 19 19 19 47 19 19 19 19 19 47 19 19 19 48 40 40 40 42 19 19 19 19 19 19 19 19 19 19 19 19 19 19 19 19 19 19 19 19 19 19 19 19 19 19 19 19 19 19 23 12 9 9 9 9 9 9 9 9 9 9 9 9 9 9 9 9 9 9 9
      19 19 19 19 19 19 19 19 19 37 40 40 40 40 40 38 19 19 19 47 19 19 19 19 19 19 19 19 19 19 19 19 19 19 19 19 19 19 19 19 19 19 19 19 19 19 19 19 19 19 19 19 19 19 19 17 9 9 9 9 9 9 9 9 9 9 9 9 9 9 9 9 9 9 9
      19 19 19 19 19 19 19 19 19 19 19 19 19 19 19 37 40 40 40 42 19 19 19 19 19 19 19 19 19 19 19 19 19 19 19 19 19 19 19 19 19 19 19 19 19 19 19 19 19 19 19 19 19 19 19 17 9 9 9 9 9 9 9 9 9 9 9 9 9 9 9 9 9 9 9
      19 19 19 19 19 19 19 19 19 19 19 19 19 19 19 19 19 19 19 19 19 19 19 19 19 19 19 19 19 19 19 19 19 19 19 19 19 19 19 19 19 19 19 19 19 19 19 19 19 19 19 19 19 19 19 17 9 9 9 9 9 9 9 9 9 9 9 9 9 9 9 9 9 9 9
      19 19 19 19 19 19 19 19 19 19 19 19 19 19 19 19 19 19 19 19 19 19 19 19 19 19 19 19 19 19 19 19 19 19 19 19 19 19 19 19 19 19 19 19 19 19 19 19 19 19 19 19 19 19 19 17 9 9 9 9 9 9 9 9 9 9 9 9 9 9 9 9 9 9 9
      19 19 19 19 19 19 19 19 19 19 19 19 19 19 19 19 19 19 19 19 19 19 19 19 19 19 19 19 19 19 19 19 19 19 19 19 19 19 19 19 19 19 19 19 19 19 19 19 19 19 19 19 19 19 19 17 9 9 9 9 9 9 9 9 9 9 9 9 9 9 9 9 9 9 9
      19 19 19 19 19 19 19 19 19 19 19 19 19 19 19 19 19 19 19 19 19 19 19 19 19 19 19 19 19 19 19 19 19 19 19 19 19 19 19 19 19 19 19 19 19 19 19 19 19 19 19 19 19 19 19 17 9 9 9 9 9 9 9 9 9 9 9 9 9 9 9 9 9 9 9
      19 19 19 19 19 19 19 19 19 19 19 19 19 19 19 19 19 19 19 19 19 19 19 19 19 19 19 19 19 19 19 19 19 19 19 19 19 19 19 19 19 19 19 19 19 19 19 19 19 19 19 19 19 19 19 17 9 9 9 9 9 9 9 9 9 9 9 9 9 9 9 9 9 9 9
      )
    )
    (level
      (name "01-Elektrisch aufgeladen!.stl")
      (x 5)
      (y 13)
    )
    (level
      (name "02-Temperaturunterschiede.stl")
      (x 8)
      (y 21)
    )
    (level
      (name "03-Eis und Schnee.stl")
      (x 11)
      (y 28)
    )
    (level
      (name "04-Bauklotze.stl")
      (x 14)
      (y 28)
    )
    (level
      (name "05-Eine bunte Welt.stl")
      (x 17)
      (y 23)
    )
    (level
      (name "06-Das Leben auf dem Eis.stl")
      (x 19)
      (y 28)
    )
    (level
      (name "07-Abstieg in die Dornhohle.stl")
      (x 23)
      (y 25)
    )
    (level
      (name "08-Die Flut.stl")
      (x 24)
      (y 23)
    )
    (level
      (name "09-Das zertrummerte Schloss.stl")
      (x 24)
      (y 20)
    )
    (level
      (name "11-finde den richtigen Weg.stl")
      (x 44)
      (y 6)
    )
    (level
      (name "12-Das Killerschloss.stl")
      (x 43)
      (y 10)
    )
    (level
      (name "13-Jedes Ende hat ein Anfang.stl")
      (x 42)
      (y 19)
    )
    (level
      (name "14-Hoch und Runter.stl")
      (x 43)
      (y 13)
    )
    (level
      (name "15-Hohlenreise.stl")
      (x 37)
      (y 15)
    )
    (level
      (name "16-Die Invasion der Schnecken.stl")
      (x 32)
      (y 15)
    )
    (level
      (name "17-Waldwege.stl")
      (x 27)
      (y 15)
    )
    (level
      (name "18-Frostige Zeiten.stl")
      (x 25)
      (y 11)
    )
    (level
      (name "19-Gefrorenes Holz.stl")
      (x 24)
      (y 13)
    )
    (level
      (name "22-Pinguine fallen nicht vom Himmel!.stl")
      (x 22)
      (y 11)
    )
    (level
      (name "21-Wenn der Schnee fallt.stl")
      (x 24)
      (y 10)
    )
    (level
      (name "20-Eine Hohle im Himmel.stl")
      (x 24)
      (y 17)
    )
    (level
      (name "23-uber dem Wald.stl")
      (x 48)
      (y 19)
    )
    (level
      (name "24-Eiskalt.stl")
      (x 55)
      (y 19)
    )
    (level
      (name "25-Ein Apfelbaum.stl")
      (x 49)
      (y 6)
    )
    (worldmap-spawnpoint
      (name "main")
      (x 3)
      (y 3)
    )
  )
  (tileset "images/worldmap.strf")
)
