(supertux-level
  (version 2)
  (name (_ "Icyisland"))
  (author "SuperTux Team")
  (contact "http://developer.berlios.de/projects/supertux/")
  (license "GPL 2 / CC-by-sa 3.0")
  (sector
    (name "main")
    (music "music/salcon.ogg")
    (ambient-light 1 1 1)
    (teleporter
      (spawnpoint "main")
      (message (_ "Go Home"))
      (sprite "images/objects/invisible/invisible.sprite")
      (x 21)
      (y 24)
    )
    (teleporter
      (spawnpoint "teleport")
      (sprite "images/objects/invisible/invisible.sprite")
      (x 14)
      (y 16)
    )
    (tilemap
      (solid #t)
      (z-pos 0)
      (width 40)
      (height 30)
      (tiles
      9 9 9 9 9 9 9 9 9 9 9 9 9 9 9 9 9 9 9 9 9 9 9 9 9 9 9 9 9 9 9 9 9 9 9 9 9 9 9 9
      9 9 9 9 9 9 9 9 9 9 9 9 9 9 9 9 9 9 9 9 9 9 9 9 9 9 9 9 9 9 9 9 9 9 9 9 9 9 9 9
      9 9 9 9 9 9 9 9 9 9 9 9 9 9 9 9 9 9 9 9 9 9 9 9 9 9 9 9 9 9 9 9 9 9 9 9 9 9 9 9
      9 9 9 11 16 16 12 9 9 9 9 9 9 9 9 9 9 9 9 9 9 9 9 9 9 9 9 9 9 9 9 9 9 9 9 9 9 9 9 9
      9 9 9 15 58 19 17 9 9 9 9 9 9 9 9 9 9 9 9 9 9 9 9 9 9 9 9 9 9 9 9 9 9 9 9 9 9 9 9 9
      9 9 9 15 59 19 17 9 9 9 9 9 9 11 16 16 16 16 16 16 16 16 16 12 9 9 9 9 9 9 9 9 9 9 9 9 9 9 9 9
      9 9 9 15 65 19 17 9 9 9 9 9 9 15 19 19 19 19 19 19 49 50 51 23 12 9 9 9 9 9 9 9 9 9 9 9 9 9 9 9
      9 9 9 15 65 19 17 417 417 417 417 417 417 15 19 19 19 19 19 19 52 53 54 19 23 16 12 9 9 9 9 9 9 9 9 9 9 9 9 9
      9 9 9 15 41 66 64 63 63 63 63 63 63 62 40 40 40 40 39 19 55 56 57 39 19 19 17 9 9 9 9 9 9 9 9 9 9 9 9 9
      9 9 9 15 47 19 17 417 417 417 417 417 417 15 19 19 19 19 47 19 19 19 19 47 19 19 17 9 9 9 9 9 9 9 9 9 9 9 9 9
      9 9 9 15 37 40 64 78 81 417 9 9 9 15 19 19 19 48 44 40 40 40 40 46 19 19 17 9 9 9 9 9 9 9 9 9 9 9 9 9
      9 9 9 14 18 18 13 417 79 417 9 9 9 14 21 19 19 47 19 19 19 19 19 47 19 19 17 9 9 9 9 9 9 9 9 9 9 9 9 9
      9 9 9 9 9 9 9 417 79 417 9 9 9 9 14 21 19 37 40 40 40 39 19 47 19 19 17 9 9 11 16 16 16 12 9 9 9 9 9 9
      9 9 9 9 9 9 9 417 79 417 9 9 9 9 9 14 18 18 18 18 21 47 19 47 20 18 13 9 9 15 410 60 19 23 12 9 9 9 9 9
      9 9 9 794 804 804 804 804 409 804 804 795 9 9 9 9 9 9 9 9 15 47 19 47 17 9 9 9 9 15 69 407 71 638 17 9 9 9 9 9
      9 9 9 808 799 799 799 799 409 799 799 800 9 11 16 16 16 12 9 9 15 47 60 47 17 9 9 9 9 15 410 47 410 637 17 9 9 9 9 9
      9 9 9 808 799 799 798 799 409 798 799 800 9 15 69 40 40 73 74 74 75 42 19 37 73 74 74 74 74 75 406 42 410 19 17 9 9 9 9 9
      9 9 9 808 799 799 799 799 409 799 799 800 9 14 18 18 18 13 9 9 15 60 60 19 17 9 9 9 9 14 18 18 18 18 13 9 9 9 9 9
      9 9 9 808 402 406 406 406 412 406 405 800 9 9 9 9 9 9 9 9 15 19 19 60 17 9 9 9 9 9 9 9 9 9 9 9 9 9 9 9
      9 9 9 808 409 799 799 799 799 798 409 800 417 417 417 417 11 16 12 9 14 18 18 18 13 9 9 9 9 9 9 9 9 9 9 9 9 9 9 9
      9 9 9 808 403 406 406 406 405 798 404 406 78 78 78 78 62 67 17 9 9 9 9 9 9 9 9 9 9 9 9 9 9 9 9 9 9 9 9 9
      9 9 9 808 409 798 799 799 409 799 799 800 417 417 417 417 14 18 13 9 11 16 16 16 16 16 12 9 9 9 9 9 9 9 9 9 9 9 9 9
      9 9 9 808 411 799 799 799 409 799 809 793 9 9 9 9 9 9 9 9 15 19 49 50 51 19 17 9 9 9 9 9 9 9 9 9 9 9 9 9
      9 9 9 792 810 810 810 810 767 810 793 9 9 9 9 9 9 9 9 9 15 19 52 53 54 19 17 9 9 9 9 9 9 9 9 9 9 9 9 9
      9 9 9 9 9 9 9 9 772 9 9 9 9 9 9 9 9 9 9 9 15 69 77 76 57 71 17 9 9 9 9 9 9 9 9 9 9 9 9 9
      9 9 9 9 9 9 9 9 9 9 9 9 9 9 9 9 9 9 9 9 14 18 18 18 18 18 13 9 9 9 9 9 9 9 9 9 9 9 9 9
      9 9 9 9 9 9 9 9 9 9 9 9 9 9 9 9 9 9 9 9 9 9 9 9 9 9 9 9 9 9 9 9 9 9 9 9 9 9 9 9
      9 9 9 9 9 9 9 9 9 9 9 9 9 9 9 9 9 9 9 9 9 9 9 9 9 9 9 9 9 9 9 9 9 9 9 9 9 9 9 9
      9 9 9 9 9 9 9 9 9 9 9 9 9 9 9 9 9 9 9 9 9 9 9 9 9 9 9 9 9 9 9 9 9 9 9 9 9 9 9 9
      9 9 9 9 9 9 9 9 9 9 9 9 9 9 9 9 9 9 9 9 9 9 9 9 9 9 9 9 9 9 9 9 9 9 9 9 9 9 9 9
      )
    )
    (level
      (name "intro.stl")
      (auto-play #t)
      (sprite "images/objects/invisible/invisible.sprite")
      (x 4)
      (y 5)
    )
    (level
      (name "8.stl")
      (x 23)
      (y 24)
    )
    (level
      (name "23.stl")
      (x 17)
      (y 20)
    )
    (level
      (name "12.stl")
      (x 4)
      (y 22)
    )
    (level
      (name "13.stl")
      (x 4)
      (y 20)
    )
    (level
      (name "4.stl")
      (x 8)
      (y 20)
    )
    (level
      (name "6.stl")
      (x 8)
      (y 18)
    )
    (level
      (name "17.stl")
      (x 13)
      (y 20)
    )
    (level
      (name "2.stl")
      (x 21)
      (y 14)
    )
    (level
      (name "5.stl")
      (x 31)
      (y 14)
    )
    (level
      (name "9.stl")
      (x 30)
      (y 16)
    )
    (level
      (name "10.stl")
      (x 32)
      (y 14)
    )
    (level
      (name "11.stl")
      (x 30)
      (y 14)
    )
    (level
      (name "3.stl")
      (x 23)
      (y 13)
    )
    (level
      (name "18.stl")
      (x 22)
      (y 8)
    )
    (level
      (name "20.stl")
      (x 23)
      (y 10)
    )
    (level
      (name "1.stl")
      (x 4)
      (y 8)
    )
    (level
      (name "22.stl")
      (x 8)
      (y 12)
    )
    (level
      (name "19.stl")
      (x 10)
      (y 8)
    )
    (level
      (name "14.stl")
      (x 16)
      (y 8)
    )
    (level
      (name "21.stl")
      (x 18)
      (y 10)
    )
    (level
      (name "15.stl")
      (x 19)
      (y 12)
    )
    (level
      (name "7.stl")
      (x 6)
      (y 18)
    )
    (level
      (name "16.stl")
      (x 8)
      (y 24)
    )
    (worldmap-spawnpoint
      (name "main")
      (x 4)
      (y 5)
    )
    (worldmap-spawnpoint
      (name "teleport")
      (x 25)
      (y 24)
    )
  )
  (tileset "images/worldmap.strf")
)
