(supertux-level
  (version 2)
  (name (_ "The Valley Of Chaos"))
  (author "semajD")
  (license "GPL 2+ / CC-by-sa 3.0")
  (sector
    (name "main")
    (music "music/voc-daytime.music")
    (ambient-light 1 1 1)
    (special-tile
      (map-message (_ "You found a Secret Level!"))
      (invisible-tile #t)
      (x 21)
      (y 11)
    )
    (tilemap
      (solid #t)
      (z-pos 0)
      (name "Interactive")
      (width 41)
      (height 25)
      (tiles
      9 9 9 9 9 9 9 9 9 9 9 9 9 9 9 9 9 9 9 9 9 9 9 9 9 9 9 9 9 11 16 12 9 9 9 9 9 9 9 9 9
      9 11 16 16 16 16 16 16 16 16 16 16 16 16 16 16 16 16 12 9 9 9 9 9 9 9 9 9 9 15 70 17 11 16 16 16 16 12 9 9 9
      9 15 19 19 19 58 19 19 19 19 19 19 19 19 19 19 19 19 17 9 9 9 9 9 9 9 9 9 11 22 65 23 22 19 19 19 60 17 9 9 9
      9 15 19 19 19 59 19 19 60 19 60 19 60 19 60 19 60 19 17 9 9 9 9 9 9 9 9 9 15 60 37 40 40 39 19 19 19 17 9 9 9
      9 15 19 19 19 47 19 19 19 19 19 19 19 19 19 19 19 19 17 9 9 9 9 9 9 9 9 9 14 18 18 18 21 37 40 40 40 64 81 9 9
      9 15 19 19 19 47 19 19 48 40 40 40 40 40 40 40 39 19 17 9 9 9 9 9 9 9 9 9 9 9 9 9 14 18 18 18 18 13 79 9 9
      9 15 24 25 26 47 19 19 47 19 19 19 19 19 19 19 47 19 17 9 9 9 9 9 9 9 9 9 9 9 9 9 9 9 9 9 9 9 79 9 9
      9 15 31 32 27 47 19 19 47 19 19 19 19 19 19 19 47 19 17 9 9 9 9 9 9 9 9 9 9 9 9 9 9 9 9 9 9 9 79 9 9
      9 15 31 32 27 47 19 19 47 19 19 60 19 19 48 40 46 19 17 9 9 9 9 9 9 9 9 9 9 9 9 9 9 9 9 9 9 9 79 9 9
      9 15 31 32 27 47 19 19 47 19 19 19 19 19 47 60 47 19 17 9 9 9 9 9 9 9 9 9 9 9 9 9 9 9 9 9 9 9 79 9 9
      9 15 30 36 27 37 40 40 42 19 48 40 40 40 44 40 42 19 17 9 11 16 12 9 9 9 9 9 9 9 9 9 9 9 9 9 9 9 79 9 9
      9 15 19 19 19 19 20 21 19 19 47 19 19 19 19 20 18 18 13 80 62 67 17 9 9 9 9 9 9 9 9 9 9 9 9 9 9 9 79 9 9
      9 15 19 19 19 19 23 22 19 19 47 19 100 110 110 64 78 78 78 85 14 18 13 9 9 9 9 9 9 9 9 9 9 9 9 9 9 9 79 9 9
      9 15 48 40 40 40 40 40 106 40 42 100 105 20 18 13 9 11 16 16 12 9 9 9 9 9 9 9 9 9 9 9 9 9 9 9 9 9 79 9 9
      9 15 47 19 19 19 19 19 104 110 110 105 48 73 74 74 74 75 40 39 17 9 9 9 9 9 9 9 9 9 9 9 9 9 9 9 9 9 79 9 9
      9 15 37 40 40 40 40 40 39 48 40 40 42 17 9 11 16 22 19 47 17 9 9 9 9 9 9 9 9 9 9 9 9 9 9 9 9 9 79 9 9
      9 15 19 20 18 18 21 19 47 47 19 19 19 17 9 15 19 19 19 47 17 9 9 9 9 9 9 9 9 9 9 9 9 9 9 9 9 9 79 9 9
      9 15 19 23 16 16 22 19 37 42 19 19 19 17 80 62 72 39 19 47 17 9 9 9 9 9 9 9 9 9 9 9 9 9 9 9 9 9 79 9 9
      9 14 18 18 18 18 18 18 18 18 18 18 18 13 79 15 19 37 40 42 17 9 9 9 9 9 9 9 9 9 9 9 9 9 9 9 9 9 79 9 9
      9 9 9 9 9 9 9 9 9 9 9 9 9 9 79 14 18 18 18 18 13 9 9 9 9 9 9 9 9 9 9 9 9 9 9 9 9 9 79 9 9
      9 9 9 9 9 9 9 9 9 9 9 9 9 9 79 9 9 9 9 9 9 9 9 9 9 9 9 9 9 9 9 9 9 9 9 9 9 9 79 9 9
      9 9 9 9 9 9 9 9 9 9 9 9 9 9 79 9 9 9 9 9 9 9 9 9 9 9 9 9 9 9 9 9 9 9 9 9 9 9 79 9 9
      9 9 9 9 9 9 9 9 9 9 9 9 9 9 79 9 9 9 9 9 9 9 9 9 9 9 9 9 9 9 9 9 9 9 9 9 9 9 79 9 9
      9 9 9 9 9 9 9 9 9 9 9 9 9 9 84 78 78 78 78 78 78 78 78 78 78 78 78 78 78 78 78 78 78 78 78 78 78 78 85 9 9
      9 9 9 9 9 9 9 9 9 9 9 9 9 9 9 9 9 9 9 9 9 9 9 9 9 9 9 9 9 9 9 9 9 9 9 9 9 9 9 9 9
      )
    )
    (tilemap
      (solid #f)
      (z-pos 120)
      (name "Foreground")
      (width 41)
      (height 25)
      (tiles
      0 0 0 0 0 0 0 0 0 0 0 0 0 0 0 0 0 0 0 0 0 0 0 0 0 0 0 0 0 0 0 0 0 0 0 0 0 0 0 0 0
      0 0 0 0 0 0 0 0 0 0 0 0 0 0 0 0 0 0 0 0 0 0 0 0 0 0 0 0 0 0 0 0 0 0 0 0 0 0 0 0 0
      0 0 0 0 0 0 0 0 0 0 0 0 0 0 0 0 0 0 0 0 0 0 0 0 0 0 0 0 0 0 0 0 0 0 0 0 0 0 0 0 0
      0 0 0 0 0 0 0 0 0 0 0 0 0 0 0 0 0 0 0 0 0 0 0 0 0 0 0 0 0 0 0 0 0 0 0 0 0 0 0 0 0
      0 0 0 0 0 0 0 0 0 0 0 0 0 0 0 0 0 0 0 0 0 0 0 0 0 0 0 0 0 0 0 0 0 0 0 0 0 0 0 0 0
      0 0 0 0 0 0 0 0 0 0 0 0 0 0 0 0 0 0 0 0 0 0 0 0 0 0 0 0 0 0 0 0 0 0 0 0 0 0 0 0 0
      0 0 0 0 0 0 0 0 0 0 0 0 0 0 0 0 0 0 0 0 0 0 0 0 0 0 0 0 0 0 0 0 0 0 0 0 0 0 0 0 0
      0 0 0 0 0 0 0 0 0 0 0 0 0 0 0 0 0 0 0 0 0 0 0 0 0 0 0 0 0 0 0 0 0 0 0 0 0 0 0 0 0
      0 0 0 0 0 0 0 0 0 0 0 0 0 0 0 0 0 0 0 0 0 0 0 0 0 0 0 0 0 0 0 0 0 0 0 0 0 0 0 0 0
      0 0 0 0 0 0 0 0 0 0 0 0 0 0 0 0 0 0 0 0 0 0 0 0 0 0 0 0 0 0 0 0 0 0 0 0 0 0 0 0 0
      0 0 0 0 0 0 0 0 0 0 0 0 0 0 0 0 0 0 0 0 0 0 0 0 0 0 0 0 0 0 0 0 0 0 0 0 0 0 0 0 0
      0 0 0 0 0 0 0 0 0 0 0 0 0 0 0 0 0 0 0 0 0 0 0 0 0 0 0 0 0 0 0 0 0 0 0 0 0 0 0 0 0
      0 0 0 0 0 0 0 0 0 0 0 0 0 0 0 0 0 0 0 0 0 0 0 0 0 0 0 0 0 0 0 0 0 0 0 0 0 0 0 0 0
      0 0 0 0 0 0 0 0 0 0 0 0 0 0 0 0 0 0 0 0 0 0 0 0 0 0 0 0 0 0 0 0 0 0 0 0 0 0 0 0 0
      0 0 0 0 0 0 0 0 0 0 0 0 0 0 0 0 0 0 0 0 0 0 0 0 0 0 0 0 0 0 0 0 0 0 0 0 0 0 0 0 0
      0 0 0 0 0 0 0 0 0 0 0 0 0 0 0 0 0 0 0 0 0 0 0 0 0 0 0 0 0 0 0 0 0 0 0 0 0 0 0 0 0
      0 0 0 0 0 0 0 0 0 0 0 0 0 0 0 0 49 50 51 0 0 0 0 0 0 0 0 0 0 0 0 0 0 0 0 0 0 0 0 0 0
      0 0 0 0 0 0 0 0 0 0 0 0 0 0 0 0 52 53 54 0 0 0 0 0 0 0 0 0 0 0 0 0 0 0 0 0 0 0 0 0 0
      0 0 0 0 0 0 0 0 0 0 0 0 0 0 0 0 55 56 57 0 0 0 0 0 0 0 0 0 0 0 0 0 0 0 0 0 0 0 0 0 0
      0 0 0 0 0 0 0 0 0 0 0 0 0 0 0 0 0 0 0 0 0 0 0 0 0 0 0 0 0 0 0 0 0 0 0 0 0 0 0 0 0
      0 0 0 0 0 0 0 0 0 0 0 0 0 0 0 0 0 0 0 0 0 0 0 0 0 0 0 0 0 0 0 0 0 0 0 0 0 0 0 0 0
      0 0 0 0 0 0 0 0 0 0 0 0 0 0 0 0 0 0 0 0 0 0 0 0 0 0 0 0 0 0 0 0 0 0 0 0 0 0 0 0 0
      0 0 0 0 0 0 0 0 0 0 0 0 0 0 0 0 0 0 0 0 0 0 0 0 0 0 0 0 0 0 0 0 0 0 0 0 0 0 0 0 0
      0 0 0 0 0 0 0 0 0 0 0 0 0 0 0 0 0 0 0 0 0 0 0 0 0 0 0 0 0 0 0 0 0 0 0 0 0 0 0 0 0
      0 0 0 0 0 0 0 0 0 0 0 0 0 0 0 0 0 0 0 0 0 0 0 0 0 0 0 0 0 0 0 0 0 0 0 0 0 0 0 0 0
      )
    )
    (tilemap
      (solid #f)
      (z-pos -100)
      (name "Background")
      (width 41)
      (height 25)
      (tiles
      0 0 0 0 0 0 0 0 0 0 0 0 0 0 0 0 0 0 0 0 0 0 0 0 0 0 0 0 0 0 0 0 0 0 0 0 0 0 0 0 0
      0 0 0 0 0 0 0 0 0 0 0 0 0 0 0 0 0 0 0 0 0 0 0 0 0 0 0 0 0 0 0 0 0 0 0 0 0 0 0 0 0
      0 0 0 0 0 0 0 0 0 0 0 0 0 0 0 0 0 0 0 0 0 0 0 0 0 0 0 0 0 0 0 0 0 0 0 0 0 0 0 0 0
      0 0 0 0 0 0 0 0 0 0 0 0 0 0 0 0 0 0 0 0 0 0 0 0 0 0 0 0 0 0 0 0 0 0 0 0 0 0 0 0 0
      0 0 0 0 0 0 0 0 0 0 0 0 0 0 0 0 0 0 0 0 0 0 0 0 0 0 0 0 0 0 0 0 0 0 0 0 0 0 0 0 0
      0 0 0 0 0 0 0 0 0 0 0 0 0 0 0 0 0 0 0 0 0 0 0 0 0 0 0 0 0 0 0 0 0 0 0 0 0 0 0 0 0
      0 0 0 0 0 0 0 0 0 0 0 0 0 0 0 0 0 0 0 0 0 0 0 0 0 0 0 0 0 0 0 0 0 0 0 0 0 0 0 0 0
      0 0 0 0 0 0 0 0 0 0 0 0 0 0 0 0 0 0 0 0 0 0 0 0 0 0 0 0 0 0 0 0 0 0 0 0 0 0 0 0 0
      0 0 0 0 0 0 0 0 0 0 0 0 0 0 0 0 0 0 0 0 0 0 0 0 0 0 0 0 0 0 0 0 0 0 0 0 0 0 0 0 0
      0 0 0 0 0 0 0 0 0 0 0 0 0 0 0 0 0 0 0 0 0 0 0 0 0 0 0 0 0 0 0 0 0 0 0 0 0 0 0 0 0
      0 0 0 0 0 0 0 0 0 0 0 0 0 0 0 0 0 0 0 0 0 0 0 0 0 0 0 0 0 0 0 0 0 0 0 0 0 0 0 0 0
      0 0 0 0 0 0 0 0 0 0 0 0 0 0 0 0 0 0 0 0 0 0 0 0 0 0 0 0 0 0 0 0 0 0 0 0 0 0 0 0 0
      0 0 0 0 0 0 0 0 0 0 0 0 19 19 19 0 0 0 0 0 0 0 0 0 0 0 0 0 0 0 0 0 0 0 0 0 0 0 0 0 0
      0 0 0 0 0 0 0 0 40 0 0 19 19 0 0 0 0 0 0 0 0 0 0 0 0 0 0 0 0 0 0 0 0 0 0 0 0 0 0 0 0
      0 0 0 0 0 0 0 0 19 19 19 19 0 0 0 0 0 0 0 0 0 0 0 0 0 0 0 0 0 0 0 0 0 0 0 0 0 0 0 0 0
      0 0 0 0 0 0 0 0 0 0 0 0 0 0 0 0 0 0 0 0 0 0 0 0 0 0 0 0 0 0 0 0 0 0 0 0 0 0 0 0 0
      0 0 0 0 0 0 0 0 0 0 0 0 0 0 0 0 0 0 0 0 0 0 0 0 0 0 0 0 0 0 0 0 0 0 0 0 0 0 0 0 0
      0 0 0 0 0 0 0 0 0 0 0 0 0 0 0 0 0 0 0 0 0 0 0 0 0 0 0 0 0 0 0 0 0 0 0 0 0 0 0 0 0
      0 0 0 0 0 0 0 0 0 0 0 0 0 0 0 0 0 0 0 0 0 0 0 0 0 0 0 0 0 0 0 0 0 0 0 0 0 0 0 0 0
      0 0 0 0 0 0 0 0 0 0 0 0 0 0 0 0 0 0 0 0 0 0 0 0 0 0 0 0 0 0 0 0 0 0 0 0 0 0 0 0 0
      0 0 0 0 0 0 0 0 0 0 0 0 0 0 0 0 0 0 0 0 0 0 0 0 0 0 0 0 0 0 0 0 0 0 0 0 0 0 0 0 0
      0 0 0 0 0 0 0 0 0 0 0 0 0 0 0 0 0 0 0 0 0 0 0 0 0 0 0 0 0 0 0 0 0 0 0 0 0 0 0 0 0
      0 0 0 0 0 0 0 0 0 0 0 0 0 0 0 0 0 0 0 0 0 0 0 0 0 0 0 0 0 0 0 0 0 0 0 0 0 0 0 0 0
      0 0 0 0 0 0 0 0 0 0 0 0 0 0 0 0 0 0 0 0 0 0 0 0 0 0 0 0 0 0 0 0 0 0 0 0 0 0 0 0 0
      0 0 0 0 0 0 0 0 0 0 0 0 0 0 0 0 0 0 0 0 0 0 0 0 0 0 0 0 0 0 0 0 0 0 0 0 0 0 0 0 0
      )
    )
    (level
      (name "level2.stl")
      (x 5)
      (y 9)
    )
    (level
      (name "level3.stl")
      (x 8)
      (y 9)
    )
    (level
      (name "level23.stl")
      (sprite "images/worldmap/common/yeti.sprite")
      (x 33)
      (y 4)
    )
    (level
      (name "level22.stl")
      (x 35)
      (y 4)
    )
    (level
      (name "level1.stl")
      (x 5)
      (y 5)
    )
    (level
      (name "level4.stl")
      (x 11)
      (y 5)
    )
    (level
      (name "level5.stl")
      (x 15)
      (y 5)
    )
    (level
      (name "level6.stl")
      (x 16)
      (y 8)
    )
    (level
      (name "level7.stl")
      (x 14)
      (y 8)
    )
    (level
      (name "level8.stl")
      (x 16)
      (y 10)
    )
    (level
      (name "level9.stl")
      (x 14)
      (y 10)
    )
    (level
      (name "level10.stl")
      (x 10)
      (y 10)
    )
    (level
      (name "level11.stl")
      (x 8)
      (y 13)
    )
    (level
      (name "level12.stl")
      (x 3)
      (y 13)
    )
    (level
      (name "level13.stl")
      (x 4)
      (y 15)
    )
    (level
      (name "level14.stl")
      (x 8)
      (y 17)
    )
    (level
      (name "level15.stl")
      (x 9)
      (y 17)
    )
    (level
      (name "level16.stl")
      (x 11)
      (y 15)
    )
    (level
      (name "level18.stl")
      (x 16)
      (y 14)
    )
    (level
      (name "level20.stl")
      (x 19)
      (y 18)
    )
    (level
      (name "level21.stl")
      (x 17)
      (y 17)
	(extro-script "wait_for_screenswitch();
   display_text_file(\"levels/The Valley Of Chaos/extro1.txt\"); ")
    )
    (level
      (name "level19.stl")
      (x 19)
      (y 15)
    )
    (level
      (name "level17.stl")
      (x 14)
      (y 14)
    )
    (level
      (name "bonus.stl")
      (x 21)
      (y 11)
    )
    (level
      (name "level24.stl")
      (quit-worldmap #t)
      (x 30)
      (y 1)
	(extro-script "wait_for_screenswitch();
   display_text_file(\"levels/The Valley Of Chaos/extro2.txt\"); ")
    )
    (worldmap-spawnpoint
      (name "main")
      (x 5)
      (y 3)
    )
  )
  (tileset "images/worldmap.strf")
)
