(supertux-level
  (version 2)
  (name (_ "Bonus Level: Where's Waldo?"))
  (author "LMH")
  (license "GPL 2 / CC-by-sa 3.0")
  (target-time 0)
  (sector
    (name "main")
    (music "music/salcon.ogg")
    (ambient-light 1 1 1)
    (bonusblock
      (script "hide.fade(0.3,3);
background.fade(0.8,3);")
      (contents "1up")
      (x 160)
      (y 896)
    )
    (camera
      (mode "normal")
    )
    (decal
      (x 1120)
      (y 384)
      (layer 100)
      (sprite "images/tiles/goal/exitfg.png")
    )
    (decal
      (x 1120)
      (y 992)
      (layer 100)
      (sprite "images/tiles/goal/exitfg.png")
    )
    (decal
      (x 1024)
      (y 384)
      (layer -50)
      (sprite "images/tiles/goal/exitbg.png")
    )
    (decal
      (x 1024)
      (y 992)
      (layer -50)
      (sprite "images/tiles/goal/exitbg.png")
    )
    (gradient
      (top_color 0 0 0)
      (bottom_color 0 0 0.4)
    )
    (infoblock
      (message (_ "!levels/mattie_world/images/LMH/hint-02.png"))
      (x 736)
      (y 576)
    )
    (secretarea
      (script "")
      (message "")
      (width 64)
      (height 64)
      (x 0)
      (y 576)
    )
    (particles-snow
    )
    (spawnpoint
      (name "main")
      (x 100)
      (y 100)
    )
    (tilemap
      (solid #f)
      (z-pos -50)
      (name "background")
      (width 43)
      (height 38)
      (tiles
      83 83 83 83 83 83 83 83 83 83 83 83 83 83 83 83 83 83 83 83 83 83 83 83 83 0 0 0 0 0 0 0 0 0 0 0 0 0 0 0 0 0 0
      83 83 83 83 83 83 83 83 83 83 83 83 83 83 83 83 83 83 83 83 83 83 83 83 83 0 0 0 0 0 0 0 0 0 0 0 0 0 0 0 0 0 0
      83 83 83 83 83 83 83 83 83 83 83 83 83 83 83 83 83 83 83 83 83 83 83 83 83 0 0 0 0 0 0 0 0 0 0 0 0 0 0 0 0 0 0
      83 83 83 83 83 83 83 83 83 83 83 83 83 83 83 83 83 83 83 83 83 83 83 83 83 0 0 0 0 0 0 0 0 0 0 0 0 0 0 0 0 0 0
      83 83 83 83 83 83 83 83 83 83 83 83 83 83 83 83 83 83 83 83 83 83 83 83 83 0 0 0 0 0 0 0 0 0 0 0 0 0 0 0 0 0 0
      83 83 83 83 83 83 83 83 83 83 83 83 83 83 83 83 83 83 83 83 83 83 83 83 83 0 0 0 0 0 0 0 0 0 0 0 0 0 0 0 0 0 0
      83 83 83 83 83 83 83 83 83 83 83 83 83 83 83 83 83 83 83 83 83 83 83 83 83 0 0 0 0 0 0 0 0 0 0 0 0 0 0 0 0 0 0
      83 83 83 83 83 83 83 83 83 83 83 83 83 83 83 83 83 83 83 83 83 83 83 83 83 0 0 0 0 0 0 0 0 0 0 0 0 0 0 0 0 0 0
      83 83 83 83 83 83 83 83 83 83 83 83 83 83 83 83 83 83 83 83 83 83 83 83 83 0 0 0 130 0 0 0 0 0 0 0 0 0 0 0 0 0 0
      83 83 83 83 83 83 83 83 83 83 83 83 83 83 83 83 83 83 83 83 83 83 83 83 83 0 0 0 129 0 0 0 0 0 0 0 0 0 0 0 0 0 0
      83 83 83 83 83 83 83 83 83 83 83 83 83 83 83 83 83 83 83 83 83 83 83 83 83 0 0 0 129 0 0 0 0 0 0 0 0 0 0 0 0 0 0
      83 83 83 83 83 83 83 83 83 83 83 83 83 83 83 83 83 83 83 83 83 83 83 83 83 0 0 0 129 0 0 0 0 0 0 0 0 0 0 0 0 0 0
      83 83 83 83 83 83 83 83 83 83 83 83 83 83 83 83 83 83 83 83 83 83 83 83 83 0 0 0 129 0 0 0 0 0 0 0 0 0 0 0 0 0 0
      83 83 83 83 83 83 83 83 83 83 83 83 83 83 83 83 83 83 83 83 83 83 83 83 83 0 0 0 129 0 0 0 0 0 0 0 0 0 0 0 0 0 0
      83 83 83 83 83 83 83 83 83 83 83 83 83 83 83 83 83 83 83 83 83 83 83 83 83 0 0 0 129 0 0 0 0 0 0 0 0 0 0 0 0 0 0
      83 83 83 83 83 83 83 83 83 83 83 83 83 83 83 83 83 83 83 83 83 83 83 83 83 0 0 0 129 0 0 0 0 0 0 0 0 0 0 0 0 0 0
      83 83 83 83 83 83 83 83 83 83 83 83 83 83 83 83 83 83 83 83 83 83 83 83 83 0 0 0 129 0 0 0 0 0 0 0 0 0 0 0 0 0 0
      83 83 83 83 83 83 83 83 83 83 83 83 83 83 83 83 83 83 83 83 83 83 83 83 83 0 0 0 129 8 0 0 0 0 0 0 0 0 8 0 8 0 0
      83 83 83 83 83 83 83 83 83 83 83 83 83 83 83 83 83 83 83 83 83 83 83 83 83 0 0 0 0 0 0 0 0 0 0 0 0 0 0 0 0 0 0
      83 83 83 83 83 83 83 83 83 83 83 83 83 83 83 83 83 83 83 83 83 83 83 83 83 0 0 0 0 0 0 0 0 0 0 0 0 0 0 0 0 0 0
      83 83 83 83 83 83 83 83 83 83 83 83 83 83 83 83 83 83 83 83 83 83 83 83 83 0 0 0 0 0 0 0 0 0 0 0 0 0 0 0 0 0 0
      83 83 83 83 83 83 83 83 83 83 83 83 83 83 83 83 83 83 83 83 83 83 83 83 83 0 0 0 0 0 0 0 0 0 0 0 0 0 0 0 0 0 0
      83 83 83 83 83 83 83 83 83 83 83 83 83 83 83 83 83 83 83 83 83 83 83 83 83 0 0 0 0 0 0 0 0 0 0 0 0 0 0 0 0 0 0
      83 83 83 83 83 83 83 83 83 83 83 83 83 83 83 83 83 83 83 83 83 83 83 83 83 0 0 0 0 0 0 0 0 0 0 0 0 0 0 0 0 0 0
      83 83 83 83 83 83 83 83 83 83 83 83 83 83 83 83 83 83 83 83 83 83 83 83 83 0 0 0 0 0 0 0 0 0 0 0 0 0 0 0 0 0 0
      83 83 83 83 83 83 83 83 83 83 83 83 83 83 83 83 83 83 83 83 83 83 83 83 83 0 0 0 0 0 0 0 0 0 0 0 0 0 0 0 0 0 0
      83 83 83 83 83 83 83 83 83 83 83 83 83 83 83 83 83 83 83 83 83 83 83 83 83 0 0 0 0 0 0 0 0 0 0 0 0 0 0 0 0 0 0
      83 83 83 83 83 83 83 83 83 83 83 83 83 83 83 83 83 83 83 83 83 83 83 83 83 0 0 0 0 0 0 0 0 0 0 0 0 0 0 0 0 0 0
      83 83 83 83 83 83 83 83 83 83 83 83 83 83 83 83 83 83 83 83 83 83 83 83 83 0 0 0 0 0 0 0 0 0 0 0 0 0 0 0 0 0 0
      83 83 83 83 83 83 83 83 83 83 83 83 83 83 83 83 83 83 83 83 83 83 83 83 83 0 0 0 0 0 0 0 0 0 0 0 0 0 0 0 0 0 0
      83 83 83 83 83 83 83 83 83 83 83 83 83 83 83 83 83 83 83 83 83 83 83 83 83 0 0 0 130 0 0 0 0 0 0 0 0 0 0 0 0 0 0
      83 83 83 83 83 83 83 83 83 83 83 83 83 83 83 83 83 83 83 83 83 83 83 83 83 0 0 0 129 0 0 0 0 0 0 0 0 0 0 0 0 0 0
      83 83 83 83 83 83 83 83 83 83 83 83 83 83 83 83 83 83 83 83 83 83 83 83 83 0 0 0 129 0 0 0 0 0 0 0 0 0 0 0 0 0 0
      83 83 83 83 83 83 83 83 83 83 83 83 83 83 83 83 83 83 83 83 83 83 83 83 83 0 0 0 129 0 0 0 0 0 0 0 0 0 0 0 0 0 0
      83 83 83 83 83 83 83 83 83 83 83 83 83 83 83 83 83 83 83 83 83 83 83 83 83 0 0 0 129 0 0 0 0 0 0 0 0 0 0 0 0 0 0
      83 83 83 83 83 83 83 83 83 83 83 83 83 83 83 83 83 83 83 83 83 83 83 83 83 0 0 0 129 0 0 0 0 0 0 0 0 0 0 0 0 0 0
      83 83 83 83 83 83 83 83 83 83 83 83 83 83 83 83 83 83 83 83 83 83 83 83 83 0 0 0 129 8 0 0 0 0 0 0 0 0 8 0 8 0 0
      83 83 83 83 83 83 83 83 83 83 83 83 83 83 83 83 83 83 83 83 83 83 83 83 83 0 0 0 0 0 0 0 0 0 0 0 0 0 0 0 0 0 0
      )
    )
    (tilemap
      (solid #t)
      (z-pos 0)
      (width 43)
      (height 38)
      (tiles
      83 0 0 0 0 0 0 0 0 0 0 0 0 0 0 0 0 0 0 0 0 0 0 0 0 0 0 0 0 133 133 133 133 133 133 133 133 133 133 133 133 133 133
      84 0 83 83 83 83 83 83 83 83 83 83 83 83 83 83 83 83 83 83 83 83 0 0 0 0 0 0 0 133 0 0 0 0 0 0 0 0 0 0 0 0 0
      84 0 84 0 0 0 0 0 0 0 0 0 0 0 0 0 0 0 0 0 0 0 0 0 0 0 0 0 0 133 0 0 0 0 0 0 0 0 0 0 0 0 0
      84 0 84 0 0 0 0 0 0 0 0 0 0 0 0 0 0 0 0 0 0 0 0 0 83 0 0 0 0 133 0 0 0 0 0 0 0 0 0 0 0 0 0
      84 0 84 0 83 83 0 0 0 0 83 83 0 0 0 0 0 0 0 0 0 102 0 0 84 0 0 0 0 133 0 0 0 0 0 0 0 0 0 0 0 0 0
      84 0 84 0 0 0 0 0 0 0 0 0 0 0 0 0 0 0 0 0 0 0 0 0 84 0 0 0 0 133 0 0 0 0 0 0 0 0 0 0 0 0 0
      84 0 84 0 0 0 0 0 0 0 0 0 0 0 0 83 83 83 84 0 0 0 0 0 84 0 0 0 0 133 0 0 0 0 0 0 0 0 0 0 0 0 0
      84 0 84 0 0 0 0 0 0 0 0 0 0 0 0 0 0 0 84 0 0 0 0 0 84 0 0 0 0 133 0 0 0 0 0 0 0 0 0 0 0 0 0
      84 0 84 0 0 83 83 0 0 83 83 83 83 83 0 0 0 0 83 83 83 83 83 83 84 0 0 0 0 133 0 0 0 0 0 0 0 0 0 0 0 0 0
      84 0 84 0 0 84 0 0 0 0 0 0 0 84 0 0 0 0 0 0 84 0 0 0 84 0 0 0 0 133 0 0 0 0 0 0 0 0 0 0 0 0 0
      84 0 84 0 0 84 0 0 0 0 0 0 0 84 0 0 0 0 0 0 84 0 0 0 84 0 0 0 0 133 0 0 0 0 0 0 0 0 0 0 0 0 0
      84 0 84 0 0 84 0 0 83 83 0 0 0 84 0 0 0 0 0 0 84 0 0 0 84 0 0 0 0 133 0 0 0 0 0 0 0 0 0 0 0 0 0
      84 0 84 0 0 84 0 0 0 0 0 0 0 84 0 0 0 0 83 83 83 0 0 0 84 0 0 0 0 133 0 0 0 0 0 0 0 0 0 0 0 0 0
      84 0 84 0 0 84 0 0 0 0 0 0 0 84 0 0 0 0 0 0 0 0 83 0 84 0 0 0 0 133 0 0 0 0 0 0 0 0 0 0 0 0 0
      84 0 84 0 0 83 83 83 83 83 0 0 83 83 83 0 0 0 0 0 0 0 0 0 83 0 0 0 0 133 0 0 0 0 0 0 0 0 0 0 0 0 0
      84 0 84 0 0 0 0 0 0 0 0 0 0 0 0 0 0 0 0 0 0 0 0 0 0 0 0 0 0 133 0 0 0 0 0 0 0 0 0 0 0 0 0
      84 0 84 0 0 0 0 0 0 0 0 0 0 0 0 0 0 0 0 0 0 0 0 0 0 0 0 0 0 133 0 0 0 0 0 0 0 0 0 0 132 0 0
      84 0 84 0 0 0 0 0 0 0 0 0 0 0 0 0 0 0 0 0 0 0 0 0 0 7 8 8 8 133 8 8 8 8 8 8 8 8 8 8 132 8 8
      84 0 84 83 83 83 84 84 2817 2817 83 83 83 83 83 83 83 83 83 83 83 83 2817 2817 2817 13 14 14 14 14 14 14 14 14 14 14 14 14 14 14 14 14 14
      84 0 84 0 0 0 0 0 0 0 0 0 0 0 0 0 0 0 0 0 0 0 0 0 0 16 17 17 17 17 17 17 17 17 17 17 17 17 17 17 17 17 17
      84 0 84 0 0 0 0 0 0 0 0 0 0 0 0 0 0 0 0 0 0 0 0 0 0 0 0 0 0 133 0 0 0 0 0 0 0 0 0 0 0 0 0
      84 0 84 0 0 0 0 0 0 0 0 0 0 0 0 0 0 0 0 0 0 0 0 0 0 0 0 0 0 133 0 0 0 0 0 0 0 0 0 0 0 0 0
      84 0 84 0 0 0 0 0 0 84 83 83 83 83 83 83 83 83 83 83 83 84 0 83 84 0 0 0 0 133 0 0 0 0 0 0 0 0 0 0 0 0 0
      84 0 84 0 0 0 0 0 0 84 0 0 0 0 0 0 0 0 0 0 0 84 0 0 84 0 0 0 0 133 0 0 0 0 0 0 0 0 0 0 0 0 0
      84 0 84 0 0 0 0 0 0 84 0 0 0 0 0 0 0 0 0 83 0 84 0 0 84 0 0 0 0 133 0 0 0 0 0 0 0 0 0 0 0 0 0
      84 0 84 0 0 0 0 0 0 84 0 0 0 0 0 0 0 0 0 0 0 84 0 0 84 0 0 0 0 133 0 0 0 0 0 0 0 0 0 0 0 0 0
      84 0 84 0 0 0 0 0 83 84 0 0 0 0 0 0 0 0 0 0 0 84 83 0 84 0 0 0 0 133 0 0 0 0 0 0 0 0 0 0 0 0 0
      84 0 84 0 0 0 0 0 0 84 0 0 0 0 0 0 0 0 0 0 0 84 0 0 84 0 0 0 0 133 0 0 0 0 0 0 0 0 0 0 0 0 0
      84 0 84 0 0 0 0 0 0 84 0 83 83 0 0 0 0 0 83 83 83 84 0 0 83 0 0 0 0 133 0 0 0 0 0 0 0 0 0 0 0 0 0
      84 0 84 0 0 0 0 0 0 84 0 0 0 0 0 0 0 0 0 0 0 84 0 0 0 0 0 0 0 133 0 0 0 0 0 0 0 0 0 0 0 0 0
      84 0 84 0 0 0 0 83 83 84 0 0 0 0 0 0 0 0 0 0 0 84 83 0 0 0 0 0 0 133 0 0 0 0 0 0 0 0 0 0 0 0 0
      84 0 84 0 0 0 0 0 0 84 0 0 0 0 0 0 0 0 0 0 0 84 84 83 0 0 0 0 0 133 0 0 0 0 0 0 0 0 0 0 0 0 0
      84 0 84 0 0 0 0 0 0 84 0 0 0 0 0 0 0 83 83 0 0 83 84 84 83 0 0 0 0 133 0 0 0 0 0 0 0 0 0 0 0 0 0
      84 0 83 83 83 83 83 83 83 83 0 0 83 83 83 0 0 0 0 0 0 0 83 83 83 0 0 0 0 133 0 0 0 0 0 0 0 0 0 0 0 0 0
      84 0 0 0 0 0 0 0 0 0 0 0 0 0 0 0 0 0 0 0 0 0 0 0 0 0 0 0 0 133 0 0 0 0 0 0 0 0 0 0 0 0 0
      84 0 0 0 0 0 0 0 0 0 0 0 0 0 0 0 0 0 0 0 0 0 0 0 0 0 0 0 0 133 0 0 0 0 0 0 0 0 0 0 132 0 0
      84 0 0 0 0 0 0 0 0 0 0 0 0 0 0 0 0 0 0 0 0 0 0 0 0 7 8 8 8 133 8 8 8 8 8 8 8 8 8 8 132 8 8
      84 83 83 84 84 84 84 84 84 83 83 83 83 84 83 83 83 83 83 83 83 83 84 84 83 13 14 14 14 14 14 14 14 14 14 14 14 14 14 14 14 14 14
      )
    )
    (tilemap
      (solid #f)
      (z-pos 100)
      (name "hide")
      (width 31)
      (height 38)
      (tiles
      83 0 0 0 0 0 0 0 0 0 0 0 0 0 0 0 0 0 0 0 0 0 0 0 84 0 0 0 0 0 0
      83 0 83 83 83 83 83 83 83 83 83 83 83 83 83 83 83 83 83 83 83 0 0 0 84 0 0 0 0 0 0
      83 0 83 0 0 0 0 0 0 0 0 0 0 0 0 0 0 0 0 0 0 0 0 0 84 0 0 0 0 0 0
      83 0 83 0 0 0 0 0 0 0 0 0 0 0 0 0 0 0 0 0 0 0 0 0 0 0 0 0 0 0 0
      83 0 83 0 0 0 0 0 0 0 0 0 0 0 0 0 0 0 0 0 0 0 0 0 0 0 0 0 0 0 0
      83 0 83 0 0 0 0 0 0 0 0 0 0 0 0 0 0 0 0 0 0 0 0 0 0 0 0 0 0 0 0
      83 0 83 0 0 0 0 0 0 0 0 0 0 0 0 0 0 0 0 0 0 0 0 0 0 0 0 0 0 0 0
      83 0 83 0 0 0 0 0 0 0 0 0 0 0 0 0 0 0 0 0 0 0 0 0 0 0 0 0 0 0 0
      83 0 83 0 0 0 0 0 0 0 0 0 0 0 0 0 0 0 0 0 0 0 0 0 0 0 0 0 0 0 130
      83 0 83 0 0 0 0 0 0 0 0 0 0 0 0 0 0 0 0 0 0 0 0 0 0 0 0 0 0 0 129
      83 0 83 0 0 0 0 0 0 0 0 0 0 0 0 0 0 0 0 0 0 0 0 0 0 0 0 0 0 0 129
      83 0 83 0 0 0 0 0 0 0 0 0 0 0 0 0 0 0 0 0 0 0 0 0 0 0 0 0 0 0 129
      83 0 83 0 0 0 0 0 0 0 0 0 0 0 0 0 0 0 0 0 0 0 0 0 0 0 0 0 0 0 129
      83 0 83 0 0 0 0 0 0 0 0 0 0 0 0 0 0 0 0 0 0 0 0 0 0 0 0 0 0 0 129
      83 0 83 0 0 0 0 0 0 0 0 0 0 0 0 0 0 0 0 0 0 0 0 0 0 0 0 0 0 0 129
      83 0 83 0 0 0 0 0 0 0 0 0 0 0 0 0 0 0 0 0 0 0 0 0 0 0 0 0 0 0 129
      83 0 83 0 0 0 0 0 0 0 0 0 0 0 0 0 0 0 0 0 0 0 0 0 0 0 0 0 0 0 129
      83 0 83 0 0 0 0 0 0 0 0 0 0 0 0 0 0 0 0 0 0 0 0 0 0 0 0 0 0 0 129
      83 0 83 0 0 0 0 0 84 84 0 0 0 0 0 0 0 0 0 0 0 0 83 83 83 0 0 0 0 0 0
      83 0 83 0 0 0 0 0 0 0 0 0 0 0 0 0 0 0 0 0 0 0 0 0 83 0 0 0 0 0 0
      83 0 83 0 0 0 0 0 0 0 0 0 0 0 0 0 0 0 0 0 0 0 0 0 83 0 0 0 0 0 0
      83 0 83 0 0 0 0 0 0 0 0 0 0 0 0 0 0 0 0 0 0 0 0 0 83 0 0 0 0 0 0
      83 0 83 0 0 0 0 0 0 83 83 83 83 83 83 83 83 83 83 83 83 83 0 0 83 0 0 0 0 0 0
      83 0 83 0 0 0 0 0 0 83 0 0 0 0 0 0 0 0 0 0 0 83 0 0 83 0 0 0 0 0 0
      83 0 83 0 0 0 0 0 0 83 0 0 0 0 0 0 0 0 0 0 0 83 0 0 83 0 0 0 0 0 0
      83 0 83 0 0 0 0 0 0 83 0 0 0 0 0 0 0 0 0 0 0 83 0 0 83 0 0 0 0 0 0
      83 0 83 0 0 0 0 0 0 83 0 0 0 0 0 0 0 0 0 0 0 83 0 0 83 0 0 0 0 0 0
      83 0 83 0 0 0 0 0 0 83 0 0 0 0 0 0 0 0 0 0 0 83 0 0 83 0 0 0 0 0 0
      83 0 83 0 0 0 0 0 0 83 0 0 0 0 0 0 0 0 0 0 0 83 0 0 83 0 0 0 0 0 0
      83 0 83 0 0 0 0 0 0 83 0 0 0 0 0 0 0 0 0 0 0 83 0 0 0 0 0 0 0 0 0
      83 0 83 0 0 0 0 0 0 83 0 0 0 0 0 0 0 0 0 0 0 83 83 0 0 0 0 0 0 0 130
      83 0 83 0 0 0 0 0 0 83 0 0 0 0 0 0 0 0 0 0 0 83 83 83 0 0 0 0 0 0 129
      83 0 83 0 0 0 0 0 0 83 0 0 0 0 0 0 0 0 0 0 0 83 83 83 83 0 0 0 0 0 129
      83 0 83 83 83 83 83 83 83 83 0 0 0 0 0 0 0 0 0 0 0 0 83 83 83 0 0 0 0 0 129
      83 0 0 0 0 0 0 0 0 0 0 0 0 0 0 0 0 0 0 0 0 0 0 0 0 0 0 0 0 0 129
      83 0 0 0 0 0 0 0 0 0 0 0 0 0 0 0 0 0 0 0 0 0 0 0 0 0 0 0 0 0 129
      83 0 0 0 0 0 0 0 0 0 0 0 0 0 0 0 0 0 0 0 0 0 0 0 0 0 0 0 0 0 129
      83 83 83 83 83 83 83 83 83 83 83 83 83 83 83 83 83 83 83 83 83 83 83 83 83 0 0 0 0 0 0
      )
    )
  )
)
