(supertux-level
  (version 2)
  (name (_ "The Frozen Continent"))
  (author "Michel")
  (license "GPL 2+ / CC-by-sa 3.0")
  (sector
    (name "main")
    (ambient-light 1 1 1)
    (camera
      (mode "normal")
    )
    (tilemap
      (solid #t)
      (z-pos 0)
      (name "Interactive")
      (path
        (node
          (x 0)
          (y 0)
        )
      )
      (width 35)
      (height 35)
      (tiles
      24 25 26 19 19 19 19 19 19 19 19 19 19 19 24 25 25 25 26 19 19 19 19 19 19 19 19 19 19 19 19 19 19 19 19
      30 29 28 19 19 48 40 40 40 40 40 40 39 19 31 35 29 36 27 24 25 26 19 19 19 19 19 19 19 19 19 19 19 19 19
      19 19 19 58 19 47 19 19 19 19 19 19 47 19 31 34 25 33 27 31 32 27 19 19 19 19 19 19 19 19 19 19 19 19 19
      19 24 26 59 48 42 48 40 40 40 40 39 37 39 30 29 29 29 28 31 32 27 24 26 19 19 19 19 19 19 19 19 19 19 19
      19 31 27 47 47 48 42 24 25 25 26 47 19 47 19 19 48 39 19 30 29 28 31 27 19 19 19 19 19 19 19 19 19 19 19
      19 30 28 37 42 47 19 31 35 36 27 37 40 46 24 26 47 37 40 40 40 39 30 28 19 19 19 19 19 19 19 19 19 19 19
      24 25 25 25 26 47 19 31 34 33 27 24 26 47 30 28 47 24 25 26 19 47 19 19 19 19 19 19 19 19 19 19 19 19 19
      31 35 29 36 27 37 39 30 29 29 28 30 28 37 40 40 42 31 32 27 19 47 24 25 26 19 19 19 19 19 19 19 19 19 19
      31 34 25 33 27 19 47 48 66 66 66 66 66 39 19 19 19 30 29 28 19 47 31 32 27 24 26 19 19 24 25 25 26 19 19
      30 29 29 29 28 48 44 42 24 25 26 19 19 37 40 39 19 48 40 40 40 42 30 29 28 30 28 19 19 31 32 32 27 19 19
      19 19 24 25 26 47 24 26 30 29 28 19 48 40 40 44 40 42 24 26 19 19 19 19 19 19 24 25 26 30 29 29 28 19 19
      19 19 31 32 27 47 30 28 19 24 25 26 47 19 24 25 26 19 30 28 19 19 19 19 19 19 31 32 27 24 25 25 25 25 25
      25 26 30 29 28 47 24 25 26 31 32 27 47 19 30 29 28 19 19 24 25 25 25 26 19 19 31 32 27 31 32 32 32 32 32
      32 34 25 25 26 47 31 32 27 30 29 28 47 24 25 25 25 25 25 33 35 29 36 27 19 19 30 29 28 31 32 32 32 32 32
      32 32 35 36 27 47 30 29 28 24 25 26 47 31 32 32 32 32 32 32 34 25 33 34 25 25 25 25 25 33 32 32 32 32 32
      32 32 34 33 27 47 24 25 25 33 32 27 47 30 36 32 35 29 36 35 36 32 32 32 32 32 32 32 32 32 32 32 32 32 32
      32 32 32 35 28 47 30 29 36 32 35 28 47 19 31 32 27 58 31 27 31 32 32 32 32 32 32 32 35 29 29 29 29 36 32
      32 32 32 34 26 47 19 19 30 29 28 19 47 19 30 29 28 59 31 34 33 32 35 29 29 29 29 29 28 24 25 25 26 31 32
      32 35 29 36 27 37 40 40 40 40 40 40 46 19 48 40 40 42 31 32 35 36 34 25 25 25 26 19 19 31 35 36 27 31 32
      32 34 25 33 27 24 25 26 19 19 19 19 37 40 42 24 25 26 31 32 27 30 29 29 29 36 27 24 26 31 34 33 27 31 32
      32 32 32 32 34 33 32 34 25 25 25 25 25 25 25 33 32 27 30 29 28 24 25 26 24 33 27 31 27 30 29 29 28 31 32
      32 32 32 32 32 32 32 32 32 32 32 32 35 36 32 32 32 34 25 25 25 33 32 27 30 29 28 30 28 19 24 25 26 31 32
      32 32 32 32 32 32 32 35 36 32 32 32 34 33 32 32 35 29 29 29 36 32 35 28 24 25 26 19 24 26 30 29 28 30 36
      32 32 32 32 32 32 32 34 33 32 32 32 32 32 32 32 27 19 19 19 30 29 28 19 31 32 27 19 30 28 19 24 25 26 31
      32 32 32 32 32 32 32 32 32 32 32 32 32 32 32 32 34 25 25 25 25 25 25 26 30 29 28 19 24 25 26 31 32 27 31
      32 32 32 32 32 32 32 32 32 32 32 32 32 32 32 32 32 32 32 32 32 32 32 34 25 25 25 26 31 32 27 30 29 28 31
      32 32 32 32 32 32 32 32 32 32 32 32 32 32 32 32 32 32 32 32 32 32 32 32 35 36 32 27 30 29 28 24 25 26 31
      32 32 32 32 32 32 32 32 32 32 32 32 32 32 32 32 32 32 32 32 32 32 32 32 34 33 32 34 25 25 25 33 32 27 31
      32 32 32 32 32 32 32 32 32 32 32 32 32 32 32 32 32 32 32 32 32 32 32 32 32 32 35 29 29 29 36 32 35 28 31
      32 32 32 32 32 32 32 32 32 32 32 32 32 32 32 32 32 32 32 32 32 32 32 32 32 32 27 19 19 19 30 29 28 19 31
      32 32 32 32 32 32 32 32 32 32 32 32 32 32 32 32 32 32 32 32 32 32 32 32 32 32 34 25 25 25 25 25 25 25 33
      32 32 32 32 32 32 32 32 32 32 32 32 32 32 32 32 32 32 32 32 32 32 32 32 32 32 32 32 32 32 32 32 32 32 32
      32 32 32 32 32 32 32 32 32 32 32 32 32 32 32 32 32 32 32 32 32 32 32 32 32 32 32 32 32 32 32 32 32 32 32
      32 32 32 32 32 32 32 32 32 32 32 32 32 32 32 32 32 32 32 32 32 32 32 32 32 32 32 32 32 32 32 32 32 32 32
      32 32 32 32 32 32 32 32 32 32 32 32 32 32 32 32 32 32 32 32 32 32 32 32 32 32 32 32 32 32 32 32 32 32 32
      )
    )
    (tilemap
      (solid #f)
      (z-pos 100)
      (name "Foreground")
      (width 35)
      (height 35)
      (tiles
      0 0 0 0 0 0 0 0 0 0 0 0 0 0 0 0 0 0 0 0 0 0 0 0 0 0 0 0 0 0 0 0 0 0 0
      0 0 0 0 0 0 0 0 0 0 0 0 0 0 0 0 0 0 0 0 0 0 0 0 0 0 0 0 0 0 0 0 0 0 0
      0 0 0 0 0 0 0 0 0 0 0 0 0 0 0 0 0 0 0 0 0 0 0 0 0 0 0 0 0 0 0 0 0 0 0
      0 0 0 0 0 0 0 0 0 0 0 0 0 0 0 0 0 0 0 0 0 0 0 0 0 0 0 0 0 0 0 0 0 0 0
      0 0 0 0 0 0 0 0 0 0 0 0 0 0 0 0 0 0 0 0 0 0 0 0 0 0 0 0 0 0 0 0 0 0 0
      0 0 0 0 0 0 0 0 0 0 0 0 0 0 0 0 0 0 0 0 0 0 0 0 0 0 0 0 0 0 0 0 0 0 0
      0 0 0 0 0 0 0 0 0 0 0 0 0 0 0 0 0 0 0 0 0 0 0 0 0 0 0 0 0 0 0 0 0 0 0
      0 0 0 0 0 0 0 0 0 0 0 0 0 0 0 0 0 0 0 0 0 0 0 0 0 0 0 0 0 0 0 0 0 0 0
      0 0 0 0 0 0 0 0 0 0 0 0 0 0 0 0 0 0 0 0 0 0 0 0 0 0 0 0 0 0 0 0 0 0 0
      0 0 0 0 0 0 0 0 0 0 0 0 0 0 0 0 0 0 0 0 0 0 0 0 0 0 0 0 0 0 0 0 0 0 0
      0 0 0 0 0 0 0 0 0 0 0 0 0 0 0 0 0 0 0 0 0 0 0 0 0 0 0 0 0 0 0 0 0 0 0
      0 0 0 0 0 0 0 0 0 0 0 0 0 0 0 0 0 0 0 0 0 0 0 0 0 0 0 0 0 0 0 0 0 0 0
      0 0 0 0 0 0 0 0 0 0 0 0 0 0 0 0 0 0 0 0 0 0 0 0 0 0 0 0 0 0 0 0 0 0 0
      0 0 0 0 0 0 0 0 0 0 0 0 0 0 0 0 0 0 0 0 0 0 0 0 0 0 0 0 0 0 0 0 0 0 0
      0 0 0 0 0 0 0 0 0 0 0 0 0 0 0 0 0 0 0 0 0 0 0 0 0 0 0 0 0 0 0 0 0 0 0
      0 0 0 0 0 0 0 0 0 0 0 0 0 0 0 0 0 0 0 0 0 0 0 0 0 0 0 0 0 0 0 0 0 0 0
      0 0 0 0 0 0 0 0 0 0 0 0 0 0 0 0 0 0 0 0 0 0 0 0 0 0 0 0 0 0 0 0 0 0 0
      0 0 0 0 0 0 0 0 0 0 0 0 0 0 0 0 0 0 0 0 0 0 0 0 0 0 0 0 0 0 0 0 0 0 0
      0 0 0 0 0 0 0 0 0 0 0 0 0 0 0 0 0 0 0 0 0 0 0 0 0 0 0 0 0 0 0 0 0 0 0
      0 0 0 0 0 0 0 0 0 0 0 0 0 0 0 0 0 0 0 0 0 0 0 0 0 0 0 0 0 0 0 0 0 0 0
      0 0 0 0 0 0 0 0 0 0 0 0 0 0 0 0 0 0 0 0 0 0 0 0 0 0 0 0 0 0 0 0 0 0 0
      0 0 0 0 0 0 0 0 0 0 0 0 0 0 0 0 0 0 0 0 0 0 0 0 0 0 0 0 0 0 0 0 0 0 0
      0 0 0 0 0 0 0 0 0 0 0 0 0 0 0 0 0 0 0 0 0 0 0 0 0 0 0 0 0 0 0 0 0 0 0
      0 0 0 0 0 0 0 0 0 0 0 0 0 0 0 0 0 0 0 0 0 0 0 0 0 0 0 0 0 0 0 0 0 0 0
      0 0 0 0 0 0 0 0 0 0 0 0 0 0 0 0 0 0 0 0 0 0 0 0 0 0 0 0 0 0 0 0 0 0 0
      0 0 0 0 0 0 0 0 0 0 0 0 0 0 0 0 0 0 0 0 0 0 0 0 0 0 0 0 0 0 0 0 0 0 0
      0 0 0 0 0 0 0 0 0 0 0 0 0 0 0 0 0 0 0 0 0 0 0 0 0 0 0 0 0 0 0 0 0 0 0
      0 0 0 0 0 0 0 0 0 0 0 0 0 0 0 0 0 0 0 0 0 0 0 0 0 0 0 0 0 0 0 0 0 0 0
      0 0 0 0 0 0 0 0 0 0 0 0 0 0 0 0 0 0 0 0 0 0 0 0 0 0 0 0 0 0 0 0 0 0 0
      0 0 0 0 0 0 0 0 0 0 0 0 0 0 0 0 0 0 0 0 0 0 0 0 0 0 0 0 0 0 0 0 0 0 0
      0 0 0 0 0 0 0 0 0 0 0 0 0 0 0 0 0 0 0 0 0 0 0 0 0 0 0 0 0 0 0 0 0 0 0
      0 0 0 0 0 0 0 0 0 0 0 0 0 0 0 0 0 0 0 0 0 0 0 0 0 0 0 0 0 0 0 0 0 0 0
      0 0 0 0 0 0 0 0 0 0 0 0 0 0 0 0 0 0 0 0 0 0 0 0 0 0 0 0 0 0 0 0 0 0 0
      0 0 0 0 0 0 0 0 0 0 0 0 0 0 0 0 0 0 0 0 0 0 0 0 0 0 0 0 0 0 0 0 0 0 0
      0 0 0 0 0 0 0 0 0 0 0 0 0 0 0 0 0 0 0 0 0 0 0 0 0 0 0 0 0 0 0 0 0 0 0
      )
    )
    (level
      (name "niveau6.stl")
      (x 13)
      (y 5)
    )
    (level
      (name "niveau9.stl")
      (x 8)
      (y 3)
    )
    (level
      (name "niveau5.stl")
      (x 16)
      (y 6)
    )
    (level
      (name "niveau3.stl")
      (x 19)
      (y 5)
    )
    (level
      (name "niveau7.stl")
      (x 21)
      (y 8)
    )
    (level
      (name "niveau1.stl")
      (x 15)
      (y 10)
    )
    (level
      (name "niveau8.stl")
      (x 12)
      (y 14)
    )
    (level
      (name "niveau4.stl")
      (x 6)
      (y 9)
    )
    (level
      (name "niveau2.stl")
      (x 5)
      (y 15)
    )
    (level
      (name "niveau10.stl")
      (x 15)
      (y 18)
    )
    (level
      (name "niveau11.stl")
      (x 11)
      (y 8)
    )
    (worldmap-spawnpoint
      (name "main")
      (x 3)
      (y 3)
    )
  )
  (tileset "images/worldmap.strf")
)
