(supertux-level
  (version 2)
  (name (_ "Mr Ice Guy Came Back"))
  (author "CT da'Bomb")
  (license "GPL 2+ / CC-by-sa 3.0")
  (sector
    (name "main")
    (music "music/bossattack.music")
    (init-script "
Effect.fade_in(1);
")
    (ambient-light 1 1 1)
    (background
      (speed 0.5)
      (image "images/background/semi_arctic.jpg")
    )
    (camera
      (mode "normal")
    )
    (particles-snow
    )
    (spawnpoint
      (name "main")
      (x 288)
      (y 640)
    )
    (yeti_stalactite
      (x 256)
      (y 324)
    )
    (yeti_stalactite
      (x 288)
      (y 324)
    )
    (yeti_stalactite
      (x 320)
      (y 324)
    )
    (yeti_stalactite
      (x 352)
      (y 324)
    )
    (yeti_stalactite
      (x 384)
      (y 324)
    )
    (yeti_stalactite
      (x 416)
      (y 324)
    )
    (yeti_stalactite
      (x 448)
      (y 324)
    )
    (yeti_stalactite
      (x 480)
      (y 324)
    )
    (yeti_stalactite
      (x 512)
      (y 324)
    )
    (yeti_stalactite
      (x 544)
      (y 324)
    )
    (yeti_stalactite
      (x 576)
      (y 324)
    )
    (yeti_stalactite
      (x 608)
      (y 324)
    )
    (yeti_stalactite
      (x 640)
      (y 324)
    )
    (yeti_stalactite
      (x 672)
      (y 324)
    )
    (yeti_stalactite
      (x 704)
      (y 324)
    )
    (yeti_stalactite
      (x 736)
      (y 324)
    )
    (yeti_stalactite
      (x 768)
      (y 324)
    )
    (yeti_stalactite
      (x 800)
      (y 324)
    )
    (yeti_stalactite
      (x 832)
      (y 324)
    )
    (yeti_stalactite
      (x 864)
      (y 324)
    )
    (yeti_stalactite
      (x 896)
      (y 324)
    )
    (yeti_stalactite
      (x 928)
      (y 324)
    )
    (yeti_stalactite
      (x 960)
      (y 324)
    )
    (yeti_stalactite
      (x 992)
      (y 324)
    )
    (tilemap
      (solid #t)
      (z-pos 0)
      (width 40)
      (height 25)
      (tiles
      2102 2102 2102 2102 2102 2102 2102 2102 2102 2102 2102 2102 2102 2102 2102 2102 2102 2102 2102 2102 2102 2102 2102 2102 2102 2102 2102 2102 2102 2102 2102 2102 2102 2102 2102 2102 2102 2102 2102 2102
      2102 2102 2102 2102 2102 2102 2102 2102 2102 2102 2102 2102 2102 2102 2102 2102 2102 2102 2102 2102 2102 2102 2102 2102 2102 2102 2102 2102 2102 2102 2102 2102 2102 2102 2102 2102 2102 2102 2102 2102
      2102 2102 2102 2102 2102 2102 2102 2102 2102 2102 2102 2102 2102 2102 2102 2102 2102 2102 2102 2102 2102 2102 2102 2102 2102 2102 2102 2102 2102 2102 2102 2102 2102 2102 2102 2102 2102 2102 2102 2102
      2102 2102 2102 2102 2102 2102 2102 2102 2102 2102 2102 2102 2102 2102 2102 2102 2102 2102 2102 2102 2102 2102 2102 2102 2102 2102 2102 2102 2102 2102 2102 2102 2102 2102 2102 2102 2102 2102 2102 2102
      2102 2102 2102 2102 2102 2102 2102 2102 2102 2102 2102 2102 2102 2102 2102 2102 2102 2102 2102 2102 2102 2102 2102 2102 2102 2102 2102 2102 2102 2102 2102 2102 2102 2102 2102 2102 2102 2102 2102 2102
      2102 2102 2102 2102 2102 2102 2102 2102 2102 2102 2102 2102 2102 2102 2102 2102 2102 2102 2102 2102 2102 2102 2102 2102 2102 2102 2102 2102 2102 2102 2102 2102 2102 2102 2102 2102 2102 2102 2102 2102
      2102 2102 2102 2102 2102 2102 2102 2102 2102 2102 2102 2102 2102 2102 2102 2102 2102 2102 2102 2102 2102 2102 2102 2102 2102 2102 2102 2102 2102 2102 2102 2102 2102 2102 2102 2102 2102 2102 2102 2102
      2102 2102 2102 2102 2102 2102 2102 2102 2102 2102 2102 2102 2102 2102 2102 2102 2102 2102 2102 2102 2102 2102 2102 2102 2102 2102 2102 2102 2102 2102 2102 2102 2102 2102 2102 2102 2102 2102 2102 2102
      2102 2102 2102 2102 2102 2102 2102 2102 2102 2102 2102 2102 2102 2102 2102 2102 2102 2102 2102 2102 2102 2102 2102 2102 2102 2102 2102 2102 2102 2102 2102 2102 2102 2102 2102 2102 2102 2102 2102 2102
      2102 2102 2102 2102 2102 2102 2102 2102 2102 2102 2102 2102 2102 2102 2102 2102 2102 2102 2102 2102 2102 2102 2102 2102 2102 2102 2102 2102 2102 2102 2102 2102 2102 2102 2102 2102 2102 2102 2102 2102
      0 0 0 0 0 0 0 0 0 0 0 0 0 0 0 0 0 0 0 0 0 0 0 0 0 0 0 0 0 0 0 0 0 0 0 0 0 0 0 0
      0 0 0 0 0 0 0 0 0 0 0 0 0 0 0 0 0 0 0 0 0 0 0 0 0 0 0 0 0 0 0 0 0 0 0 0 0 0 0 0
      0 0 0 0 0 0 0 0 0 0 0 0 0 0 0 0 0 0 0 0 0 0 0 0 0 0 0 0 0 0 0 0 0 0 0 0 0 0 0 0
      0 0 0 0 0 0 0 0 0 0 0 0 0 0 0 0 0 0 0 0 0 0 0 0 0 0 0 0 0 0 0 0 0 0 0 0 0 0 0 0
      0 0 0 0 0 0 0 0 0 0 0 0 0 0 0 0 0 0 0 0 0 0 0 0 0 0 0 0 0 0 0 0 0 0 0 0 0 0 0 0
      0 0 0 0 0 0 0 0 0 0 0 0 0 0 0 0 0 0 0 0 0 0 0 0 0 0 0 0 0 0 0 0 0 0 0 0 0 0 0 0
      338 338 338 338 338 338 338 339 0 0 0 0 0 0 0 0 0 0 0 0 0 0 0 0 0 0 0 0 0 0 0 0 337 338 338 338 338 338 338 338
      1477 1477 1477 1477 1483 1484 1485 1503 0 0 0 0 0 0 0 0 0 0 0 0 0 0 0 0 0 0 0 0 0 0 0 0 1503 1477 1477 1477 1477 1477 1477 1477
      1477 1477 1477 1477 1490 1491 1492 1503 0 0 0 0 0 0 0 0 0 0 0 0 0 0 0 0 0 0 0 0 0 0 0 0 1503 1477 1477 1477 1477 1477 1477 1477
      1477 1479 1480 1481 1497 1498 1499 1503 0 0 0 0 0 0 0 0 0 0 0 0 0 0 0 0 0 0 0 0 0 0 0 0 1503 1477 1477 1477 1477 1477 1477 1477
      1477 1486 1487 1488 1504 1505 1506 1503 0 0 0 0 0 0 0 0 0 0 0 0 0 0 0 0 0 0 0 0 0 0 0 0 1503 1477 1479 1480 1481 1477 1477 1477
      1477 1493 1494 1495 1477 1477 1477 1503 0 0 0 0 0 0 0 0 0 0 0 0 0 0 0 0 0 0 0 0 0 0 0 0 1503 1477 1486 1487 1488 1477 1477 1477
      1477 1500 1501 1502 1477 1477 1477 1503 0 0 0 0 0 0 0 0 0 0 0 0 0 0 0 0 0 0 0 0 0 0 0 0 1503 1477 1493 1494 1495 1477 1477 1477
      1477 1507 1508 1509 1477 1477 1477 1503 337 338 338 338 338 338 338 338 338 338 338 338 338 338 338 338 338 338 338 338 338 338 338 339 1503 1477 1500 1501 1502 1477 1477 1477
      1477 1477 1477 1477 1477 1477 1477 1477 1477 1477 1477 1477 1477 1477 1477 1477 1477 1477 1477 1477 1477 1477 1477 1477 1477 1477 1477 1477 1477 1477 1477 1477 1477 1477 1507 1508 1509 1477 1477 1477
      )
    )
    (tilemap
      (solid #f)
      (z-pos -100)
      (name "back")
      (width 40)
      (height 25)
      (tiles
      0 0 0 0 0 0 0 0 0 0 0 0 0 0 0 0 0 0 0 0 0 0 0 0 0 0 0 0 0 0 0 0 0 0 0 0 0 0 0 0
      0 0 0 0 0 0 0 0 0 0 0 0 0 0 0 0 0 0 0 0 0 0 0 0 0 0 0 0 0 0 0 0 0 0 0 0 0 0 0 0
      0 0 0 0 0 0 0 0 0 0 0 0 0 0 0 0 0 0 0 0 0 0 0 0 0 0 0 0 0 0 0 0 0 0 0 0 0 0 0 0
      0 0 0 0 0 0 0 0 0 0 0 0 0 0 0 0 0 0 0 0 0 0 0 0 0 0 0 0 0 0 0 0 0 0 0 0 0 0 0 0
      0 0 0 0 0 0 0 0 0 0 0 0 0 0 0 0 0 0 0 0 0 0 0 0 0 0 0 0 0 0 0 0 0 0 0 0 0 0 0 0
      0 0 0 0 0 0 0 0 0 0 0 0 0 0 0 0 0 0 0 0 0 0 0 0 0 0 0 0 0 0 0 0 0 0 0 0 0 0 0 0
      2271 2268 2269 2270 2271 2268 2269 2270 2271 0 0 0 0 0 0 0 0 0 0 0 0 0 0 0 0 0 0 0 0 0 0 0 0 0 0 0 0 0 0 0
      2283 2280 2281 2282 2283 2280 2281 2282 2283 0 0 0 0 0 0 0 0 0 0 0 0 0 0 0 0 0 0 0 0 0 0 0 0 0 0 0 0 0 0 0
      2295 2292 2293 2294 2295 2292 2293 2294 2295 0 0 0 0 0 0 0 0 0 0 0 0 0 0 0 0 0 0 0 0 0 0 0 0 0 0 0 0 0 0 0
      2307 2304 2305 2306 2307 2304 2305 2306 2307 2358 2359 0 0 2260 2261 2262 2263 0 2260 2261 2262 2263 0 0 0 0 2312 2313 2314 2315 2356 2357 0 0 0 0 0 0 0 0
      2271 2316 2317 2318 2319 2316 2317 2318 2319 2370 2371 2358 2359 2272 2273 2274 2275 2382 2272 2273 2274 2275 2264 2265 2266 2267 2324 2325 2326 2327 2368 2369 2356 2357 2356 2357 2268 2269 2270 2271
      2283 2328 2329 2330 2331 2328 2329 2330 2331 2358 2359 2370 2371 2264 2266 2267 2212 2213 2214 2215 2310 2311 2276 2277 2278 2279 2336 2337 2338 2339 2356 2357 2368 2369 2368 2369 2280 2281 2282 2283
      2295 2382 2382 2212 2213 2214 2215 2310 2311 2370 2371 2314 2315 2276 2278 2279 2224 2225 2226 2227 2322 2323 2288 2289 2290 2291 2348 2349 2350 2351 2368 2369 2212 2213 2214 2215 2292 2293 2294 2295
      2307 2382 2382 2224 2225 2226 2227 2322 2323 2358 2359 2326 2327 2288 2290 2291 2358 2359 2310 2311 2346 2347 2300 2301 2302 2303 2382 2212 2213 2214 2215 2382 2224 2225 2226 2227 2304 2305 2306 2307
      2319 2264 2265 2266 2267 2358 2359 2334 2335 2370 2371 2350 2351 2300 2302 2303 2370 2371 2322 2323 2260 2261 2262 2263 2310 2311 2382 2224 2225 2226 2227 2382 2260 2261 2262 2263 2316 2317 2318 2319
      2331 2276 2277 2278 2279 2370 2371 2346 2347 2212 2213 2214 2215 2310 2311 2358 2359 2382 2334 2335 2272 2273 2274 2275 2322 2323 2356 2357 2356 2357 2382 2382 2272 2273 2274 2275 2328 2329 2330 2331
      2382 2288 2289 2290 2291 2382 2382 2382 2382 2224 2225 2226 2227 2322 2323 2370 2371 2382 2346 2347 2212 2213 2214 2215 2322 2323 2368 2369 2368 2369 2310 2311 2224 2225 2226 2227 0 0 0 0
      2382 2300 2301 2302 2303 2382 2382 2382 2382 2268 2269 2270 2271 2334 2335 2212 2213 2215 2356 2357 2228 2233 2234 2235 2334 2335 2212 2213 2214 2215 2322 2323 2382 0 0 0 0 0 0 0
      2382 2382 2382 2382 2382 2382 2382 2382 2382 2280 2281 2282 2283 2346 2347 2224 2225 2227 2368 2369 2224 2225 2226 2227 2346 2347 2224 2225 2226 2227 2334 2335 2382 0 0 0 0 0 0 0
      2382 2382 2382 2382 2212 2212 2213 2214 2215 2292 2293 2294 2295 2380 2381 2358 2359 2356 2357 2264 2265 2311 2358 2359 2382 2310 2311 2382 2383 2382 2346 2347 2382 0 0 0 0 0 0 0
      2382 2382 2382 2382 2224 2224 2225 2226 2227 2304 2305 2306 2307 2310 2311 2370 2371 2368 2369 2276 2277 2323 2370 2371 2383 2322 2323 2212 2213 2214 2215 2310 2311 0 0 0 0 0 0 0
      2382 2382 2382 2382 2382 2382 2382 2310 2311 2316 2317 2318 2319 2322 2323 2212 2213 2214 2215 2276 2277 2323 2383 2358 2359 2334 2335 2224 2225 2226 2227 2322 2323 0 0 0 0 0 0 0
      2382 2382 2382 2382 2382 2382 2382 2322 2323 2328 2329 2330 2331 2334 2335 2224 2225 2226 2227 2288 2289 2335 2382 2370 2371 2346 2347 2356 2357 2356 2357 2334 2335 0 0 0 0 0 0 0
      2382 2382 2382 2382 2382 2382 2382 2334 2335 2340 2341 2342 2343 2346 2347 2224 2225 2226 2227 0 2346 2347 0 0 0 2346 2347 2368 2369 2368 2369 2346 2347 2383 0 0 0 0 0 0
      2382 2382 2382 2382 2382 2382 2382 2346 2347 2352 2353 2354 2355 0 0 0 0 0 0 0 0 0 0 0 0 0 0 0 0 0 0 2382 2382 0 0 0 0 0 0 0
      )
    )
    (yeti
      (dead-script "sector.Tux.trigger_sequence(\"fireworks\");")
      (x 17)
      (y 396)
    )
  )
)
