(supertux-level
  (version 2)
  (name (_ "Bonus cave"))(license "GPL 2+ / CC-by-sa 3.0")
  (author "Hume")
  (sector
    (name "main")
    (ambient-light 1 1 1)
    (special-tile
      (invisible-tile #t)
      (script "Foreground.fade(0,1)
frfr.fade(0,1)")
      (x 18)
      (y 12)
    )
    (special-tile
      (invisible-tile #t)
      (script "Foreground.fade(1,1)
frfr.fade(1,1)")
      (x 25)
      (y 12)
    )
    (special-tile
      (invisible-tile #t)
      (script "Foreground.fade(0,1)
frfr.fade(0,1)")
      (x 25)
      (y 13)
    )
    (special-tile
      (invisible-tile #t)
      (script "Foreground.fade(0,1)
frfr.fade(0,1)")
      (x 28)
      (y 16)
    )
    (special-tile
      (invisible-tile #t)
      (script "Foreground.fade(0,1)
frfr.fade(0,1)")
      (x 28)
      (y 15)
    )
    (special-tile
      (invisible-tile #t)
      (script "Foreground.fade(0,1)
frfr.fade(0,1)")
      (x 8)
      (y 12)
    )
    (special-tile
      (invisible-tile #t)
      (script "Foreground.fade(0,1)
frfr.fade(0,1)")
      (x 18)
      (y 13)
    )
    (special-tile
      (invisible-tile #t)
      (script "Foreground.fade(0,1)
frfr.fade(0,1)")
      (x 19)
      (y 12)
    )
    (special-tile
      (invisible-tile #t)
      (script "Foreground.fade(0,1)
frfr.fade(0,1)")
      (x 18)
      (y 11)
    )
    (special-tile
      (invisible-tile #t)
      (script "Foreground.fade(0,1)
frfr.fade(0,1)")
      (x 17)
      (y 8)
    )
    (special-tile
      (invisible-tile #t)
      (script "Foreground.fade(0,1)
frfr.fade(0,1)")
      (x 9)
      (y 8)
    )
    (special-tile
      (invisible-tile #t)
      (script "Foreground.fade(0,1)
frfr.fade(0,1)")
      (x 11)
      (y 12)
    )
    (special-tile
      (invisible-tile #t)
      (script "Foreground.fade(0,1)
frfr.fade(0,1)")
      (x 12)
      (y 12)
    )
    (special-tile
      (invisible-tile #t)
      (script "Foreground.fade(0,1)
frfr.fade(0,1)")
      (x 13)
      (y 12)
    )
    (special-tile
      (invisible-tile #t)
      (script "Foreground.fade(0,1)
frfr.fade(0,1)")
      (x 14)
      (y 12)
    )
    (special-tile
      (invisible-tile #t)
      (script "Foreground.fade(0,1)
frfr.fade(0,1)")
      (x 15)
      (y 12)
    )
    (special-tile
      (invisible-tile #t)
      (script "Foreground.fade(0,1)
frfr.fade(0,1)")
      (x 17)
      (y 16)
    )
    (special-tile
      (invisible-tile #t)
      (script "Foreground.fade(0,1)
frfr.fade(0,1)")
      (x 9)
      (y 16)
    )
    (teleporter
      (worldmap "levels/hume_rainbow_cave/worldmap.stwm")
      (spawnpoint "bonus")
      (automatic #t)
      (x 34)
      (y 12)
    )
    (tilemap
      (z-pos 0)
      (solid #t)
      (name "Interactive")
      (width 35)
      (height 25)
      (tiles
      9 9 9 9 9 9 9 9 9 9 9 9 9 9 9 9 9 9 9 9 9 9 9 9 9 9 9 9 9 9 9 9 9 9 11
      9 9 9 9 9 9 9 9 9 9 9 9 9 9 9 9 9 9 9 9 9 9 9 9 9 9 9 9 9 9 9 9 9 11 22
      9 9 9 9 9 9 9 9 9 9 9 9 9 9 9 9 9 9 9 9 9 9 9 9 9 9 9 9 9 9 9 9 11 22 19
      9 9 9 9 9 9 9 9 9 9 9 9 9 9 9 9 9 9 9 9 9 9 9 9 9 9 9 9 9 9 9 9 15 19 19
      9 9 9 9 9 9 9 9 9 9 9 9 9 9 9 9 9 9 9 9 9 9 9 9 9 9 9 9 9 9 9 9 15 19 19
      9 9 9 9 9 9 9 9 9 9 9 9 9 9 9 9 9 9 9 9 9 9 9 9 9 9 9 9 9 9 9 9 15 19 19
      9 9 9 9 9 9 9 9 654 655 655 655 655 655 655 655 655 655 655 655 655 656 9 9 9 9 9 9 9 9 9 9 15 19 19
      9 9 9 9 9 9 9 654 633 758 762 762 762 762 762 762 762 761 560 560 560 614 655 655 655 655 655 656 9 9 9 9 15 19 19
      9 9 9 9 9 9 9 649 758 764 560 560 560 560 758 762 762 768 761 560 560 560 735 733 733 691 692 653 9 9 9 9 15 19 19
      9 9 9 9 9 9 9 649 765 760 762 761 560 560 765 560 560 560 765 560 560 560 757 748 748 696 697 9 9 9 9 9 15 19 19
      9 9 9 9 9 9 9 649 765 560 560 765 560 560 765 560 560 560 765 560 560 560 757 809 810 793 9 9 9 9 9 9 15 19 19
      9 9 9 9 9 9 9 649 765 560 560 765 560 560 765 560 560 560 759 761 560 560 757 800 654 655 656 9 9 9 9 9 15 19 19
      9 9 9 9 9 9 9 649 759 762 762 768 763 762 768 763 762 762 764 759 762 761 757 800 641 758 74 74 74 74 74 74 75 40 40
      9 9 9 9 9 9 9 649 765 560 560 560 765 560 560 765 560 560 759 769 560 765 757 800 641 765 614 655 655 655 655 656 14 18 18
      9 9 9 9 9 9 9 649 765 560 560 560 765 560 560 765 560 560 765 560 560 765 757 800 641 765 560 758 761 560 560 652 9 9 9
      9 9 9 9 9 9 9 649 765 560 560 560 765 560 560 760 762 761 765 560 560 765 757 800 1884 765 560 760 764 1874 1875 614 655 656 9
      9 9 9 9 9 9 9 649 760 763 762 762 769 560 560 560 560 759 769 560 560 765 757 838 839 717 712 712 714 790 690 691 692 653 9
      9 9 9 9 9 9 9 631 632 760 762 762 762 762 762 762 762 769 560 560 560 765 757 748 748 748 748 748 409 790 790 696 697 9 9
      9 9 9 9 9 9 9 9 631 694 694 694 694 694 694 694 694 694 694 632 758 769 757 748 748 748 748 748 409 790 790 800 9 9 9
      9 9 9 9 9 9 9 9 9 9 9 9 9 9 9 9 9 9 9 641 765 735 736 748 748 748 748 748 409 790 790 800 9 9 9
      9 9 9 9 9 9 9 9 9 9 9 9 9 9 9 9 9 9 9 641 760 750 751 406 406 406 406 406 413 790 790 800 9 9 9
      9 9 9 9 9 9 9 9 9 9 9 9 9 9 9 9 9 9 9 641 560 755 756 790 790 790 790 790 790 790 790 807 9 9 9
      9 9 9 9 9 9 9 9 9 9 9 9 9 9 9 9 9 9 9 631 694 694 695 703 703 703 703 703 703 703 703 793 9 9 9
      9 9 9 9 9 9 9 9 9 9 9 9 9 9 9 9 9 9 9 9 9 9 9 9 9 9 9 9 9 9 9 9 9 9 9
      9 9 9 9 9 9 9 9 9 9 9 9 9 9 9 9 9 9 9 9 9 9 9 9 9 9 9 9 9 9 9 9 9 9 9
      )
    )
    (tilemap
      (z-pos 102)
      (solid #f)
      (name "Foreground")
      (width 35)
      (height 25)
      (tiles
      0 0 0 0 0 0 0 0 0 0 0 0 0 0 0 0 0 0 0 0 0 0 0 0 0 0 0 0 0 0 0 0 0 0 0
      0 0 0 0 0 0 0 0 0 0 0 0 0 0 0 0 0 0 0 0 0 0 0 0 0 0 0 0 0 0 0 0 0 0 0
      0 0 0 0 0 0 0 0 0 0 0 0 0 0 0 0 0 0 0 0 0 0 0 0 0 0 0 0 0 0 0 0 0 0 0
      0 0 0 0 0 0 0 0 0 0 0 0 0 0 0 0 0 0 0 0 0 0 0 0 0 0 0 0 0 0 0 0 0 0 0
      0 0 0 0 0 906 0 0 0 0 0 0 0 0 0 0 0 0 0 0 0 0 0 0 0 0 0 0 0 0 0 0 0 0 0
      0 0 0 0 0 906 906 906 906 906 906 906 906 906 906 906 906 906 906 906 906 906 906 0 0 0 0 0 0 0 0 0 0 0 0
      0 0 0 0 0 906 906 906 794 804 804 804 804 804 804 804 804 804 804 804 804 795 0 0 0 0 0 0 0 0 0 0 0 0 0
      0 0 0 0 906 906 906 794 839 790 790 870 565 566 565 566 870 790 565 566 790 838 804 804 804 804 804 795 0 0 0 0 0 0 0
      0 0 0 0 906 906 906 791 790 790 871 872 574 575 574 575 870 790 574 575 789 790 565 566 790 809 801 793 0 0 0 0 0 0 0
      0 0 0 0 906 906 906 791 565 566 880 881 583 584 583 584 870 790 583 584 798 799 574 575 790 800 9 0 0 0 0 0 0 0 0
      0 0 0 0 906 906 906 791 574 575 870 870 870 870 870 870 870 790 790 790 790 790 583 584 790 800 0 0 0 0 0 0 0 0 0
      0 0 0 0 906 906 906 791 583 584 790 790 871 872 790 790 802 803 790 790 565 566 790 565 566 838 795 0 0 0 0 0 0 0 0
      0 0 0 0 0 906 906 791 790 790 790 790 880 881 790 790 811 812 790 790 574 575 790 574 575 790 800 0 0 0 0 0 0 0 0
      0 0 0 0 0 906 906 791 790 871 872 873 874 875 876 877 878 790 789 790 583 584 790 583 584 790 838 804 804 804 804 795 0 0 0
      0 0 0 0 0 906 906 791 790 880 881 882 883 884 885 886 887 790 798 799 790 790 790 790 790 790 790 790 790 802 803 800 0 0 0
      0 0 0 0 0 906 906 791 790 790 890 891 892 893 894 895 896 790 565 566 790 871 872 873 874 875 876 877 878 811 812 838 804 795 0
      0 0 0 0 0 906 906 791 790 790 899 900 901 902 903 904 905 790 574 575 790 880 881 882 883 884 885 886 887 790 790 809 810 793 0
      0 0 0 0 0 906 906 792 818 790 907 908 909 910 911 912 913 790 583 584 790 889 890 891 892 893 894 895 896 565 566 800 9 0 0
      0 0 0 0 0 906 906 906 792 810 810 810 810 810 810 810 810 810 810 818 790 898 899 900 901 902 903 904 905 574 575 800 0 0 0
      0 0 0 0 0 906 906 906 906 906 906 906 906 906 906 906 906 906 906 791 565 566 907 908 909 910 911 912 913 583 584 800 0 0 0
      0 0 0 0 0 0 0 0 0 0 0 0 0 0 0 0 0 0 0 791 574 575 790 790 789 790 790 802 803 802 803 800 0 0 0
      0 0 0 0 0 0 0 0 0 0 0 0 0 0 0 0 0 0 0 791 583 584 790 790 798 799 790 811 812 811 812 800 0 0 0
      0 0 0 0 0 0 0 0 0 0 0 0 0 0 0 0 0 0 0 792 801 801 801 801 801 801 801 801 801 801 801 793 0 0 0
      0 0 0 0 0 0 0 0 0 0 0 0 0 0 0 0 0 0 0 0 0 0 0 0 0 0 0 0 0 0 0 0 0 0 0
      0 0 0 0 0 0 0 0 0 0 0 0 0 0 0 0 0 0 0 0 0 0 0 0 0 0 0 0 0 0 0 0 0 0 0
      )
    )
    (tilemap
      (z-pos 103)
      (solid #f)
      (name "frfr")
      (width 35)
      (height 25)
      (tiles
      0 0 0 0 0 0 0 0 0 0 0 0 0 0 0 0 0 0 0 0 0 0 0 0 0 0 0 0 0 0 0 0 0 0 0
      0 0 0 0 0 0 0 0 0 0 0 0 0 0 0 0 0 0 0 0 0 0 0 0 0 0 0 0 0 0 0 0 0 0 0
      0 0 0 0 0 0 0 0 0 0 0 0 0 0 0 0 0 0 0 0 0 0 0 0 0 0 0 0 0 0 0 0 0 0 0
      0 0 0 0 0 0 0 0 0 0 0 0 0 0 0 0 0 0 0 0 0 0 0 0 0 0 0 0 0 0 0 0 0 0 0
      0 0 0 0 0 0 0 906 906 906 906 906 906 906 906 906 906 906 906 906 0 0 0 0 0 0 0 0 0 0 0 0 0 0 0
      0 0 0 0 0 0 0 906 906 906 819 906 906 906 819 906 906 906 906 906 0 0 0 0 0 0 0 0 0 0 0 0 0 0 0
      0 0 0 0 0 0 0 0 0 0 828 819 0 906 828 0 0 819 0 0 819 0 0 0 0 0 0 0 0 0 0 0 0 0 0
      0 0 0 0 0 0 0 843 844 819 0 828 0 0 0 0 0 828 0 0 828 0 0 0 0 0 0 0 0 0 0 0 0 0 0
      0 0 0 0 0 0 906 852 853 828 0 0 843 844 0 843 844 0 0 0 0 0 0 0 825 826 0 0 0 0 0 0 0 0 0
      0 0 0 0 0 906 906 861 862 0 0 0 852 853 820 852 853 0 906 906 825 826 906 0 834 835 0 0 0 0 0 0 0 0 0
      0 0 0 0 0 906 906 906 0 0 825 826 861 862 829 861 862 906 825 826 834 835 906 0 0 0 0 0 0 0 0 0 0 0 0
      0 0 0 0 0 906 906 906 0 0 834 835 0 0 0 817 831 832 834 835 906 906 0 0 0 0 843 844 0 0 0 0 0 0 0
      0 0 0 0 0 906 906 906 819 0 0 819 0 0 819 819 843 844 906 906 906 906 0 0 0 0 852 853 0 0 0 820 0 0 0
      0 0 0 0 0 906 906 906 828 0 0 828 0 0 828 828 852 853 906 825 826 906 825 826 825 826 861 862 0 0 0 829 0 0 0
      0 0 0 0 0 906 906 843 844 0 0 0 0 0 0 0 861 862 906 834 835 0 834 835 834 835 906 906 820 832 831 0 820 820 0
      0 0 0 0 0 906 906 852 853 0 0 0 0 0 906 843 844 0 906 906 906 0 0 906 906 906 906 832 829 831 832 0 829 829 0
      0 0 0 0 0 906 906 861 862 843 844 832 819 825 826 852 853 0 906 819 0 0 0 0 0 0 0 0 0 0 0 820 0 0 0
      0 0 0 0 0 906 906 906 906 852 853 906 828 834 835 861 862 0 819 828 819 0 0 846 847 848 849 850 851 0 0 829 0 0 0
      0 0 0 0 0 906 906 906 906 861 862 906 906 906 906 0 0 0 828 0 828 0 0 855 856 857 858 859 860 0 0 0 0 0 0
      0 0 0 0 0 0 0 0 0 0 0 0 0 0 0 0 0 0 0 0 0 0 0 864 865 866 867 868 869 0 0 0 0 0 0
      0 0 0 0 0 0 0 0 0 0 0 0 0 0 0 0 0 0 0 0 0 0 819 819 820 820 820 832 831 832 831 0 0 0 0
      0 0 0 0 0 0 0 0 0 0 0 0 0 0 0 0 0 0 0 0 0 0 828 828 829 829 829 831 832 831 832 0 0 0 0
      0 0 0 0 0 0 0 0 0 0 0 0 0 0 0 0 0 0 0 0 0 0 0 0 0 0 0 0 0 0 0 0 0 0 0
      0 0 0 0 0 0 0 0 0 0 0 0 0 0 0 0 0 0 0 0 0 0 0 0 0 0 0 0 0 0 0 0 0 0 0
      0 0 0 0 0 0 0 0 0 0 0 0 0 0 0 0 0 0 0 0 0 0 0 0 0 0 0 0 0 0 0 0 0 0 0
      )
    )
    (tilemap
      (z-pos 100)
      (solid #f)
      (width 35)
      (height 25)
      (tiles
      0 0 0 0 0 0 0 0 0 0 0 0 0 0 0 0 0 0 0 0 0 0 0 0 0 0 0 0 0 0 0 0 0 0 0
      0 0 0 0 0 0 0 0 0 0 0 0 0 0 0 0 0 0 0 0 0 0 0 0 0 0 0 0 0 0 0 0 0 0 0
      0 0 0 0 0 0 0 0 0 0 0 0 0 0 0 0 0 0 0 0 0 0 0 0 0 0 0 0 0 0 0 0 0 0 0
      0 0 0 0 0 0 0 0 0 0 0 0 0 0 0 0 0 0 0 0 0 0 0 0 0 0 0 0 0 0 0 0 0 0 0
      0 0 0 0 0 0 0 0 0 0 0 0 0 0 0 0 0 0 0 0 0 0 0 0 0 0 0 0 0 0 0 0 0 0 0
      0 0 0 0 0 0 0 0 0 0 0 0 0 0 0 0 0 0 0 0 0 0 0 0 0 0 0 0 0 0 0 0 0 0 0
      0 0 0 0 0 0 0 0 0 0 0 0 0 0 0 0 0 0 0 0 0 0 0 0 0 0 0 0 0 0 0 0 0 0 0
      0 0 0 0 0 0 0 0 0 0 0 0 0 0 0 0 0 0 0 0 0 0 0 0 0 0 0 0 0 0 0 0 0 0 0
      0 0 0 0 0 0 0 0 0 0 0 0 0 0 0 0 0 0 0 0 0 0 0 0 0 0 0 0 0 0 0 0 0 0 0
      0 0 0 0 0 0 0 0 0 0 0 0 0 0 0 0 0 0 0 0 0 0 0 0 0 0 0 0 0 0 0 0 0 0 0
      0 0 0 0 0 0 0 0 0 0 0 0 0 0 0 0 0 0 0 0 0 0 0 0 0 0 0 0 0 0 0 0 0 0 0
      0 0 0 0 0 0 0 0 0 0 0 0 0 0 0 0 0 0 0 0 0 0 0 0 0 655 656 0 0 0 0 0 0 0 0
      0 0 0 0 0 0 0 0 0 0 0 0 0 0 0 0 0 0 0 0 0 0 0 0 0 560 652 0 0 0 0 0 0 0 0
      0 0 0 0 0 0 0 0 0 0 0 0 0 0 0 0 0 0 0 0 0 0 0 0 0 560 0 0 0 0 0 0 0 0 0
      0 0 0 0 0 0 0 0 0 0 0 0 0 0 0 0 0 0 0 0 0 0 0 0 0 560 0 0 0 0 0 0 0 0 0
      0 0 0 0 0 0 0 0 0 0 0 0 0 0 0 0 0 0 0 0 0 0 0 0 0 1873 0 0 0 0 1873 0 0 0 0
      0 0 0 0 0 0 0 0 0 0 0 0 0 0 0 0 0 0 0 0 0 0 0 0 0 906 0 0 0 0 0 0 0 0 0
      0 0 0 0 0 0 0 0 0 0 0 0 0 0 0 0 0 0 0 0 0 0 0 0 0 0 0 0 0 0 0 0 0 0 0
      0 0 0 0 0 0 0 0 0 0 0 0 0 0 0 0 0 0 0 0 0 0 0 0 0 0 0 0 0 0 0 0 0 0 0
      0 0 0 0 0 0 0 0 0 0 0 0 0 0 0 0 0 0 0 0 0 0 0 0 0 0 0 0 0 0 0 0 0 0 0
      0 0 0 0 0 0 0 0 0 0 0 0 0 0 0 0 0 0 0 0 0 0 0 0 0 0 0 0 0 0 0 0 0 0 0
      0 0 0 0 0 0 0 0 0 0 0 0 0 0 0 0 0 0 0 0 0 0 0 0 0 0 0 0 0 0 0 0 0 0 0
      0 0 0 0 0 0 0 0 0 0 0 0 0 0 0 0 0 0 0 0 0 0 0 0 0 0 0 0 0 0 0 0 0 0 0
      0 0 0 0 0 0 0 0 0 0 0 0 0 0 0 0 0 0 0 0 0 0 0 0 0 0 0 0 0 0 0 0 0 0 0
      0 0 0 0 0 0 0 0 0 0 0 0 0 0 0 0 0 0 0 0 0 0 0 0 0 0 0 0 0 0 0 0 0 0 0
      )
    )
    (tilemap
      (z-pos 101)
      (solid #f)
      (width 35)
      (height 25)
      (tiles
      0 0 0 0 0 0 0 0 0 0 0 0 0 0 0 0 0 0 0 0 0 0 0 0 0 0 0 0 0 0 0 0 0 0 0
      0 0 0 0 0 0 0 0 0 0 0 0 0 0 0 0 0 0 0 0 0 0 0 0 0 0 0 0 0 0 0 0 0 0 0
      0 0 0 0 0 0 0 0 0 0 0 0 0 0 0 0 0 0 0 0 0 0 0 0 0 0 0 0 0 0 0 0 0 0 0
      0 0 0 0 0 0 0 0 0 0 0 0 0 0 0 0 0 0 0 0 0 0 0 0 0 0 0 0 0 0 0 0 0 0 0
      0 0 0 0 0 0 0 0 0 0 0 0 0 0 0 0 0 0 0 0 0 0 0 0 0 0 0 0 0 0 0 0 0 0 0
      0 0 0 0 0 0 0 0 0 0 0 0 0 0 0 0 0 0 0 0 0 0 0 0 0 0 0 0 0 0 0 0 0 0 0
      0 0 0 0 0 0 0 0 0 0 0 0 0 0 0 0 0 0 0 0 0 0 0 0 0 0 0 0 0 0 0 0 0 0 0
      0 0 0 0 0 0 0 0 0 0 0 0 0 0 0 0 0 0 0 0 0 0 0 0 0 0 0 0 0 0 0 0 0 0 0
      0 0 0 0 0 0 0 0 0 0 0 0 0 0 0 0 0 0 0 0 0 0 0 0 0 0 0 0 0 0 0 0 0 0 0
      0 0 0 0 0 0 0 0 0 0 0 0 0 0 0 0 0 0 0 0 0 0 0 0 0 0 0 0 0 0 0 0 0 0 0
      0 0 0 0 0 0 0 0 0 0 0 0 0 0 0 0 0 0 0 0 0 0 0 0 0 0 0 0 0 0 0 0 0 0 0
      0 0 0 0 0 0 0 0 0 0 0 0 0 0 0 0 0 0 0 0 0 0 0 0 0 0 843 844 0 0 0 0 0 0 0
      0 0 0 0 0 0 0 0 0 0 0 0 0 0 0 0 0 0 0 0 0 0 0 0 0 0 852 853 0 0 0 0 0 0 0
      0 0 0 0 0 0 0 0 0 0 0 0 0 0 0 0 0 0 0 0 0 0 0 0 0 0 861 862 0 0 0 0 0 0 0
      0 0 0 0 0 0 0 0 0 0 0 0 0 0 0 0 0 0 0 0 0 0 0 0 0 0 0 0 0 0 0 0 0 0 0
      0 0 0 0 0 0 0 0 0 0 0 0 0 0 0 0 0 0 0 0 0 0 0 0 0 0 0 0 0 0 0 0 0 0 0
      0 0 0 0 0 0 0 0 0 0 0 0 0 0 0 0 0 0 0 0 0 0 0 0 0 0 906 906 0 0 0 0 0 0 0
      0 0 0 0 0 0 0 0 0 0 0 0 0 0 0 0 0 0 0 0 0 0 0 0 0 0 0 0 0 0 0 0 0 0 0
      0 0 0 0 0 0 0 0 0 0 0 0 0 0 0 0 0 0 0 0 0 0 0 0 0 0 0 0 0 0 0 0 0 0 0
      0 0 0 0 0 0 0 0 0 0 0 0 0 0 0 0 0 0 0 0 0 0 0 0 0 0 0 0 0 0 0 0 0 0 0
      0 0 0 0 0 0 0 0 0 0 0 0 0 0 0 0 0 0 0 0 0 0 0 0 0 0 0 0 0 0 0 0 0 0 0
      0 0 0 0 0 0 0 0 0 0 0 0 0 0 0 0 0 0 0 0 0 0 0 0 0 0 0 0 0 0 0 0 0 0 0
      0 0 0 0 0 0 0 0 0 0 0 0 0 0 0 0 0 0 0 0 0 0 0 0 0 0 0 0 0 0 0 0 0 0 0
      0 0 0 0 0 0 0 0 0 0 0 0 0 0 0 0 0 0 0 0 0 0 0 0 0 0 0 0 0 0 0 0 0 0 0
      0 0 0 0 0 0 0 0 0 0 0 0 0 0 0 0 0 0 0 0 0 0 0 0 0 0 0 0 0 0 0 0 0 0 0
      )
    )
    (level
      (name "white7.stl")
      (x 13)
      (y 12)
      (sprite "images/worldmap/common/shroom.sprite")
    )
    (level
      (name "red7.stl")
      (x 18)
      (y 12)
      (sprite "images/worldmap/common/shroom.sprite")
    )
    (level
      (name "orange7.stl")
      (x 17)
      (y 16)
      (sprite "images/worldmap/common/shroom.sprite")
    )
    (level
      (name "yellow7.stl")
      (x 9)
      (y 16)
      (sprite "images/worldmap/common/shroom.sprite")
    )
    (level
      (name "green7.stl")
      (x 8)
      (y 12)
      (sprite "images/worldmap/common/shroom.sprite")
    )
    (level
      (name "blue7.stl")
      (x 9)
      (y 8)
      (sprite "images/worldmap/common/shroom.sprite")
    )
    (level
      (name "purple7.stl")
      (x 17)
      (y 8)
      (sprite "images/worldmap/common/shroom.sprite")
    )
    (worldmap-spawnpoint
      (name "main")
      (auto-dir "west")
      (x 34)
      (y 12)
    )
  )
  (tileset "images/worldmap.strf")
)
