(supertux-level																																										
	(version 2)																																									
	(name (_ "Bonus Level: Where's Waldo?"))																																									
	(author "LMH")																																									
	(license	"GPL 2 / CC-by-sa 3.0"	)																																							
	(sector																																									
		(name "main")																																								
		(music	"music/salcon.ogg"	)																																						
		(ambient-light 1 1 1)																																								
		(camera	(mode	"normal"	))																																					
		(particles-snow)																																								
		(gradient	(top_color	0	0	0	)																																			
			(bottom_color	0	0	0.4	))													    																						
																																										
		(spawnpoint	(name "main")																																							
			(x 100)		(y 100)		)																																			
		(secretarea	(width	64	)(height	64	)																																			
			(x	0	)(y	576	))																																			
		(infoblock	(message (_ "!images/LMH/hint-02.png"))																																							
			(x	736	)(y	576	))																																			
		(bonusblock	(x	160	)(y	896	)(contents	"1up"	))																																	
																																										
		(tilemap	(name	"igloo-back"	)																																					
			(z-pos	-50	)(solid	#f	)																																			
			(path	(node	(x	1024	)(y	384	))	)																																
			(width	1	)(height	20	)																																			
			(tiles	126	0	0	0	0	0	0	0	0	0	0	0	0	0	0	0	0	0	0	126	))																		
		(tilemap	(name	"igloo-front"	)																																					
			(z-pos	100	)(solid	#f	)																																			
			(path	(node	(x	1120	)(y	384	))	)																																
			(width	1	)(height	20	)																																			
			(tiles	127	0	0	0	0	0	0	0	0	0	0	0	0	0	0	0	0	0	0	127	))																		
		(tilemap	(name	"background"	)(alpha	1	)																																			
			(z-pos -50)		(solid #f)																																					
			(speed 1)																																							
			(width	43	)(height 38)																																					
			(tiles																																							
26	26	26	26	26	26	26	26	26	26	26	26	26	26	26	26	26	26	26	26	26	26	26	26	26	0	0	0	0	0	0	0	0	0	0	0	0	0	0	0	0	0	0
26	26	26	26	26	26	26	26	26	26	26	26	26	26	26	26	26	26	26	26	26	26	26	26	26	0	0	0	0	0	0	0	0	0	0	0	0	0	0	0	0	0	0
26	26	26	26	26	26	26	26	26	26	26	26	26	26	26	26	26	26	26	26	26	26	26	26	26	0	0	0	0	0	0	0	0	0	0	0	0	0	0	0	0	0	0
26	26	26	26	26	26	26	26	26	26	26	26	26	26	26	26	26	26	26	26	26	26	26	26	26	0	0	0	0	0	0	0	0	0	0	0	0	0	0	0	0	0	0
26	26	26	26	26	26	26	26	26	26	26	26	26	26	26	26	26	26	26	26	26	26	26	26	26	0	0	0	0	0	0	0	0	0	0	0	0	0	0	0	0	0	0
26	26	26	26	26	26	26	26	26	26	26	26	26	26	26	26	26	26	26	26	26	26	26	26	26	0	0	0	0	0	0	0	0	0	0	0	0	0	0	0	0	0	0
26	26	26	26	26	26	26	26	26	26	26	26	26	26	26	26	26	26	26	26	26	26	26	26	26	0	0	0	0	0	0	0	0	0	0	0	0	0	0	0	0	0	0
26	26	26	26	26	26	26	26	26	26	26	26	26	26	26	26	26	26	26	26	26	26	26	26	26	0	0	0	0	0	0	0	0	0	0	0	0	0	0	0	0	0	0
26	26	26	26	26	26	26	26	26	26	26	26	26	26	26	26	26	26	26	26	26	26	26	26	26	0	0	0	130	0	0	0	0	0	0	0	0	0	0	0	0	0	0
26	26	26	26	26	26	26	26	26	26	26	26	26	26	26	26	26	26	26	26	26	26	26	26	26	0	0	0	129	0	0	0	0	0	0	0	0	0	0	0	0	0	0
26	26	26	26	26	26	26	26	26	26	26	26	26	26	26	26	26	26	26	26	26	26	26	26	26	0	0	0	129	0	0	0	0	0	0	0	0	0	0	0	0	0	0
26	26	26	26	26	26	26	26	26	26	26	26	26	26	26	26	26	26	26	26	26	26	26	26	26	0	0	0	129	0	0	0	0	0	0	0	0	0	0	0	0	0	0
26	26	26	26	26	26	26	26	26	26	26	26	26	26	26	26	26	26	26	26	26	26	26	26	26	0	0	0	129	0	0	0	126	0	0	127	0	0	0	0	0	0	0
26	26	26	26	26	26	26	26	26	26	26	26	26	26	26	26	26	26	26	26	26	26	26	26	26	0	0	0	129	0	0	0	0	0	0	0	0	0	0	0	0	0	0
26	26	26	26	26	26	26	26	26	26	26	26	26	26	26	26	26	26	26	26	26	26	26	26	26	0	0	0	129	0	0	0	0	0	0	0	0	0	0	0	0	0	0
26	26	26	26	26	26	26	26	26	26	26	26	26	26	26	26	26	26	26	26	26	26	26	26	26	0	0	0	129	0	0	0	0	0	0	0	0	0	0	0	0	0	0
26	26	26	26	26	26	26	26	26	26	26	26	26	26	26	26	26	26	26	26	26	26	26	26	26	0	0	0	129	0	0	0	0	0	0	0	0	0	0	0	0	0	0
26	26	26	26	26	26	26	26	26	26	26	26	26	26	26	26	26	26	26	26	26	26	26	26	26	0	0	0	129	8	0	0	0	0	0	0	0	0	8	0	8	0	0
26	26	26	26	26	26	26	26	26	26	26	26	26	26	26	26	26	26	26	26	26	26	26	26	26	0	0	0	0	0	0	0	0	0	0	0	0	0	0	0	0	0	0
26	26	26	26	26	26	26	26	26	26	26	26	26	26	26	26	26	26	26	26	26	26	26	26	26	0	0	0	0	0	0	0	0	0	0	0	0	0	0	0	0	0	0
26	26	26	26	26	26	26	26	26	26	26	26	26	26	26	26	26	26	26	26	26	26	26	26	26	0	0	0	0	0	0	0	0	0	0	0	0	0	0	0	0	0	0
26	26	26	26	26	26	26	26	26	26	26	26	26	26	26	26	26	26	26	26	26	26	26	26	26	0	0	0	0	0	0	0	0	0	0	0	0	0	0	0	0	0	0
26	26	26	26	26	26	26	26	26	26	26	26	26	26	26	26	26	26	26	26	26	26	26	26	26	0	0	0	0	0	0	0	0	0	0	0	0	0	0	0	0	0	0
26	26	26	26	26	26	26	26	26	26	26	26	26	26	26	26	26	26	26	26	26	26	26	26	26	0	0	0	0	0	0	0	0	0	0	0	0	0	0	0	0	0	0
26	26	26	26	26	26	26	26	26	26	26	26	26	26	26	26	26	26	26	26	26	26	26	26	26	0	0	0	0	0	0	0	0	0	0	0	0	0	0	0	0	0	0
26	26	26	26	26	26	26	26	26	26	26	26	26	26	26	26	26	26	26	26	26	26	26	26	26	0	0	0	0	0	0	0	0	0	0	0	0	0	0	0	0	0	0
26	26	26	26	26	26	26	26	26	26	26	26	26	26	26	26	26	26	26	26	26	26	26	26	26	0	0	0	0	0	0	0	0	0	0	0	0	0	0	0	0	0	0
26	26	26	26	26	26	26	26	26	26	26	26	26	26	26	26	26	26	26	26	26	26	26	26	26	0	0	0	0	0	0	0	0	0	0	0	0	0	0	0	0	0	0
26	26	26	26	26	26	26	26	26	26	26	26	26	26	26	26	26	26	26	26	26	26	26	26	26	0	0	0	0	0	0	0	0	0	0	0	0	0	0	0	0	0	0
26	26	26	26	26	26	26	26	26	26	26	26	26	26	26	26	26	26	26	26	26	26	26	26	26	0	0	0	0	0	0	0	0	0	0	0	0	0	0	0	0	0	0
26	26	26	26	26	26	26	26	26	26	26	26	26	26	26	26	26	26	26	26	26	26	26	26	26	0	0	0	130	0	0	0	0	0	0	0	0	0	0	0	0	0	0
26	26	26	26	26	26	26	26	26	26	26	26	26	26	26	26	26	26	26	26	26	26	26	26	26	0	0	0	129	0	0	0	126	0	0	127	0	0	0	0	0	0	0
26	26	26	26	26	26	26	26	26	26	26	26	26	26	26	26	26	26	26	26	26	26	26	26	26	0	0	0	129	0	0	0	0	0	0	0	0	0	0	0	0	0	0
26	26	26	26	26	26	26	26	26	26	26	26	26	26	26	26	26	26	26	26	26	26	26	26	26	0	0	0	129	0	0	0	0	0	0	0	0	0	0	0	0	0	0
26	26	26	26	26	26	26	26	26	26	26	26	26	26	26	26	26	26	26	26	26	26	26	26	26	0	0	0	129	0	0	0	0	0	0	0	0	0	0	0	0	0	0
26	26	26	26	26	26	26	26	26	26	26	26	26	26	26	26	26	26	26	26	26	26	26	26	26	0	0	0	129	0	0	0	0	0	0	0	0	0	0	0	0	0	0
26	26	26	26	26	26	26	26	26	26	26	26	26	26	26	26	26	26	26	26	26	26	26	26	26	0	0	0	129	8	0	0	0	0	0	0	0	0	8	0	8	0	0
26	26	26	26	26	26	26	26	26	26	26	26	26	26	26	26	26	26	26	26	26	26	26	26	26	0	0	0	0	0	0	0	0	0	0	0	0	0	0	0	0	0	0
			)																																							
		)																																								
		(tilemap																																								
			(z-pos 0)																																							
			(solid #t)																																							
			(speed 1)																																							
			(width 43)																																							
			(height 38)																																							
			(tiles																																							
26	0	0	0	0	0	0	0	0	0	0	0	0	0	0	0	0	0	0	0	0	0	0	0	0	0	0	0	0	133	133	133	133	133	133	133	133	133	133	133	133	133	133
84	0	26	26	26	26	26	26	26	26	26	26	26	26	26	26	26	26	26	26	26	26	0	0	0	0	0	0	0	133	0	0	0	0	0	0	0	0	0	0	0	0	0
84	0	84	0	0	0	0	0	0	0	0	0	0	0	0	0	0	0	0	0	0	0	0	0	0	0	0	0	0	133	0	0	0	0	0	0	0	0	0	0	0	0	0
84	0	84	0	0	0	0	0	0	0	0	0	0	0	0	0	0	0	0	0	0	0	0	0	26	0	0	0	0	133	0	0	0	0	0	0	0	0	0	0	0	0	0
84	0	84	0	26	26	0	0	0	0	26	26	0	0	0	0	0	0	0	0	0	102	0	0	84	0	0	0	0	133	0	0	0	0	0	0	0	0	0	0	0	0	0
84	0	84	0	0	0	0	0	0	0	0	0	0	0	0	0	0	0	0	0	0	0	0	0	84	0	0	0	0	133	0	0	0	0	0	0	0	0	0	0	0	0	0
84	0	84	0	0	0	0	0	0	0	0	0	0	0	0	26	26	26	84	0	0	0	0	0	84	0	0	0	0	133	0	0	0	0	0	0	0	0	0	0	0	0	0
84	0	84	0	0	0	0	0	0	0	0	0	0	0	0	0	0	0	84	0	0	0	0	0	84	0	0	0	0	133	0	0	0	0	0	0	0	0	0	0	0	0	0
84	0	84	0	0	26	26	0	0	26	26	26	26	26	0	0	0	0	26	26	26	26	26	26	84	0	0	0	0	133	0	0	0	0	0	0	0	0	0	0	0	0	0
84	0	84	0	0	84	0	0	0	0	0	0	0	84	0	0	0	0	0	0	84	0	0	0	84	0	0	0	0	133	0	0	0	0	0	0	0	0	0	0	0	0	0
84	0	84	0	0	84	0	0	0	0	0	0	0	84	0	0	0	0	0	0	84	0	0	0	84	0	0	0	0	133	0	0	0	0	0	0	0	0	0	0	0	0	0
84	0	84	0	0	84	0	0	26	26	0	0	0	84	0	0	0	0	0	0	84	0	0	0	84	0	0	0	0	133	0	0	0	0	0	0	0	0	0	0	0	0	0
84	0	84	0	0	84	0	0	0	0	0	0	0	84	0	0	0	0	26	26	26	0	0	0	84	0	0	0	0	133	0	0	0	0	0	0	0	0	0	0	0	0	0
84	0	84	0	0	84	0	0	0	0	0	0	0	84	0	0	0	0	0	0	0	0	26	0	84	0	0	0	0	133	0	0	0	0	0	0	0	0	0	0	0	0	0
84	0	84	0	0	26	26	26	26	26	0	0	26	26	26	0	0	0	0	0	0	0	0	0	26	0	0	0	0	133	0	0	0	0	0	0	0	0	0	0	0	0	0
84	0	84	0	0	0	0	0	0	0	0	0	0	0	0	0	0	0	0	0	0	0	0	0	0	0	0	0	0	133	0	0	0	0	0	0	0	0	0	0	0	0	0
84	0	84	0	0	0	0	0	0	0	0	0	0	0	0	0	0	0	0	0	0	0	0	0	0	0	0	0	0	133	0	0	0	0	0	0	0	0	0	0	132	0	0
84	0	84	0	0	0	0	0	0	0	0	0	0	0	0	0	0	0	0	0	0	0	0	0	0	7	8	8	8	133	8	8	8	8	8	8	8	8	8	8	132	8	8
84	0	84	26	26	26	84	84	2817	2817	26	26	26	26	26	26	26	26	26	26	26	26	2817	2817	2817	13	14	14	14	14	14	14	14	14	14	14	14	14	14	14	14	14	14
84	0	84	0	0	0	0	0	0	0	0	0	0	0	0	0	0	0	0	0	0	0	0	0	0	16	17	17	17	17	17	17	17	17	17	17	17	17	17	17	17	17	17
84	0	84	0	0	0	0	0	0	0	0	0	0	0	0	0	0	0	0	0	0	0	0	0	0	0	0	0	0	133	0	0	0	0	0	0	0	0	0	0	0	0	0
84	0	84	0	0	0	0	0	0	0	0	0	0	0	0	0	0	0	0	0	0	0	0	0	0	0	0	0	0	133	0	0	0	0	0	0	0	0	0	0	0	0	0
84	0	84	0	0	0	0	0	0	84	26	26	26	26	26	26	26	26	26	26	26	84	0	26	84	0	0	0	0	133	0	0	0	0	0	0	0	0	0	0	0	0	0
84	0	84	0	0	0	0	0	0	84	0	0	0	0	0	0	0	0	0	0	0	84	0	0	84	0	0	0	0	133	0	0	0	0	0	0	0	0	0	0	0	0	0
84	0	84	0	0	0	0	0	0	84	0	0	0	0	0	0	0	0	0	26	0	84	0	0	84	0	0	0	0	133	0	0	0	0	0	0	0	0	0	0	0	0	0
84	0	84	0	0	0	0	0	0	84	0	0	0	0	0	0	0	0	0	0	0	84	0	0	84	0	0	0	0	133	0	0	0	0	0	0	0	0	0	0	0	0	0
84	0	84	0	0	0	0	0	26	84	0	0	0	0	0	0	0	0	0	0	0	84	26	0	84	0	0	0	0	133	0	0	0	0	0	0	0	0	0	0	0	0	0
84	0	84	0	0	0	0	0	0	84	0	0	0	0	0	0	0	0	0	0	0	84	0	0	84	0	0	0	0	133	0	0	0	0	0	0	0	0	0	0	0	0	0
84	0	84	0	0	0	0	0	0	84	0	26	26	0	0	0	0	0	26	26	26	84	0	0	26	0	0	0	0	133	0	0	0	0	0	0	0	0	0	0	0	0	0
84	0	84	0	0	0	0	0	0	84	0	0	0	0	0	0	0	0	0	0	0	84	0	0	0	0	0	0	0	133	0	0	0	0	0	0	0	0	0	0	0	0	0
84	0	84	0	0	0	0	26	26	84	0	0	0	0	0	0	0	0	0	0	0	84	26	0	0	0	0	0	0	133	0	0	0	0	0	0	0	0	0	0	0	0	0
84	0	84	0	0	0	0	0	0	84	0	0	0	0	0	0	0	0	0	0	0	84	84	26	0	0	0	0	0	133	0	0	0	0	0	0	0	0	0	0	0	0	0
84	0	84	0	0	0	0	0	0	84	0	0	0	0	0	0	0	26	26	0	0	26	84	84	26	0	0	0	0	133	0	0	0	0	0	0	0	0	0	0	0	0	0
84	0	26	26	26	26	26	26	26	26	0	0	26	26	26	0	0	0	0	0	0	0	26	26	26	0	0	0	0	133	0	0	0	0	0	0	0	0	0	0	0	0	0
84	0	0	0	0	0	0	0	0	0	0	0	0	0	0	0	0	0	0	0	0	0	0	0	0	0	0	0	0	133	0	0	0	0	0	0	0	0	0	0	0	0	0
84	0	0	0	0	0	0	0	0	0	0	0	0	0	0	0	0	0	0	0	0	0	0	0	0	0	0	0	0	133	0	0	0	0	0	0	0	0	0	0	132	0	0
84	0	0	0	0	0	0	0	0	0	0	0	0	0	0	0	0	0	0	0	0	0	0	0	0	7	8	8	8	133	8	8	8	8	8	8	8	8	8	8	132	8	8
84	26	26	84	84	84	84	84	84	26	26	26	26	84	26	26	26	26	26	26	26	26	84	84	26	13	14	14	14	14	14	14	14	14	14	14	14	14	14	14	14	14	14
			)																																							
		)																																								
		(tilemap	(name	"hide"	)(alpha	1	)																																			
			(z-pos	100	)(solid	#f	)																																			
			(speed 1)																																							
			(width	31	)(height 38)																																					
			(tiles																																							
26	0	0	0	0	0	0	0	0	0	0	0	0	0	0	0	0	0	0	0	0	0	0	0	84	0	0	0	0	0	0												
26	0	26	26	26	26	26	26	26	26	26	26	26	26	26	26	26	26	26	26	26	0	0	0	84	0	0	0	0	0	0												
26	0	26	0	0	0	0	0	0	0	0	0	0	0	0	0	0	0	0	0	0	0	0	0	84	0	0	0	0	0	0												
26	0	26	0	0	0	0	0	0	0	0	0	0	0	0	0	0	0	0	0	0	0	0	0	0	0	0	0	0	0	0												
26	0	26	0	0	0	0	0	0	0	0	0	0	0	0	0	0	0	0	0	0	0	0	0	0	0	0	0	0	0	0												
26	0	26	0	0	0	0	0	0	0	0	0	0	0	0	0	0	0	0	0	0	0	0	0	0	0	0	0	0	0	0												
26	0	26	0	0	0	0	0	0	0	0	0	0	0	0	0	0	0	0	0	0	0	0	0	0	0	0	0	0	0	0												
26	0	26	0	0	0	0	0	0	0	0	0	0	0	0	0	0	0	0	0	0	0	0	0	0	0	0	0	0	0	0												
26	0	26	0	0	0	0	0	0	0	0	0	0	0	0	0	0	0	0	0	0	0	0	0	0	0	0	0	0	0	130												
26	0	26	0	0	0	0	0	0	0	0	0	0	0	0	0	0	0	0	0	0	0	0	0	0	0	0	0	0	0	129												
26	0	26	0	0	0	0	0	0	0	0	0	0	0	0	0	0	0	0	0	0	0	0	0	0	0	0	0	0	0	129												
26	0	26	0	0	0	0	0	0	0	0	0	0	0	0	0	0	0	0	0	0	0	0	0	0	0	0	0	0	0	129												
26	0	26	0	0	0	0	0	0	0	0	0	0	0	0	0	0	0	0	0	0	0	0	0	0	0	0	0	0	0	129												
26	0	26	0	0	0	0	0	0	0	0	0	0	0	0	0	0	0	0	0	0	0	0	0	0	0	0	0	0	0	129												
26	0	26	0	0	0	0	0	0	0	0	0	0	0	0	0	0	0	0	0	0	0	0	0	0	0	0	0	0	0	129												
26	0	26	0	0	0	0	0	0	0	0	0	0	0	0	0	0	0	0	0	0	0	0	0	0	0	0	0	0	0	129												
26	0	26	0	0	0	0	0	0	0	0	0	0	0	0	0	0	0	0	0	0	0	0	0	0	0	0	0	0	0	129												
26	0	26	0	0	0	0	0	0	0	0	0	0	0	0	0	0	0	0	0	0	0	0	0	0	0	0	0	0	0	129												
26	0	26	0	0	0	0	0	84	84	0	0	0	0	0	0	0	0	0	0	0	0	26	26	26	0	0	0	0	0	0												
26	0	26	0	0	0	0	0	0	0	0	0	0	0	0	0	0	0	0	0	0	0	0	0	26	0	0	0	0	0	0												
26	0	26	0	0	0	0	0	0	0	0	0	0	0	0	0	0	0	0	0	0	0	0	0	26	0	0	0	0	0	0												
26	0	26	0	0	0	0	0	0	0	0	0	0	0	0	0	0	0	0	0	0	0	0	0	26	0	0	0	0	0	0												
26	0	26	0	0	0	0	0	0	26	26	26	26	26	26	26	26	26	26	26	26	26	0	0	26	0	0	0	0	0	0												
26	0	26	0	0	0	0	0	0	26	0	0	0	0	0	0	0	0	0	0	0	26	0	0	26	0	0	0	0	0	0												
26	0	26	0	0	0	0	0	0	26	0	0	0	0	0	0	0	0	0	0	0	26	0	0	26	0	0	0	0	0	0												
26	0	26	0	0	0	0	0	0	26	0	0	0	0	0	0	0	0	0	0	0	26	0	0	26	0	0	0	0	0	0												
26	0	26	0	0	0	0	0	0	26	0	0	0	0	0	0	0	0	0	0	0	26	0	0	26	0	0	0	0	0	0												
26	0	26	0	0	0	0	0	0	26	0	0	0	0	0	0	0	0	0	0	0	26	0	0	26	0	0	0	0	0	0												
26	0	26	0	0	0	0	0	0	26	0	0	0	0	0	0	0	0	0	0	0	26	0	0	26	0	0	0	0	0	0												
26	0	26	0	0	0	0	0	0	26	0	0	0	0	0	0	0	0	0	0	0	26	0	0	0	0	0	0	0	0	0												
26	0	26	0	0	0	0	0	0	26	0	0	0	0	0	0	0	0	0	0	0	26	26	0	0	0	0	0	0	0	130												
26	0	26	0	0	0	0	0	0	26	0	0	0	0	0	0	0	0	0	0	0	26	26	26	0	0	0	0	0	0	129												
26	0	26	0	0	0	0	0	0	26	0	0	0	0	0	0	0	0	0	0	0	26	26	26	26	0	0	0	0	0	129												
26	0	26	26	26	26	26	26	26	26	0	0	0	0	0	0	0	0	0	0	0	0	26	26	26	0	0	0	0	0	129												
26	0	0	0	0	0	0	0	0	0	0	0	0	0	0	0	0	0	0	0	0	0	0	0	0	0	0	0	0	0	129												
26	0	0	0	0	0	0	0	0	0	0	0	0	0	0	0	0	0	0	0	0	0	0	0	0	0	0	0	0	0	129												
26	0	0	0	0	0	0	0	0	0	0	0	0	0	0	0	0	0	0	0	0	0	0	0	0	0	0	0	0	0	129												
26	26	26	26	26	26	26	26	26	26	26	26	26	26	26	26	26	26	26	26	26	26	26	26	26	0	0	0	0	0	0												
		)	)																																							
		(scripttrigger	(script "	hide.fade(0.3,3);background.fade(0.8,3);	")(button	#f	)																																			
			(width	16	)(height	64	)																																			
			(x	264	)(y	624	))																																			
)	)																																									
