(supertux-level
  (version 2)
  (name (_ "The torture"))
  (author "Hume")
  (sector
    (name "main")
    (music "music/bossattack.ogg")
    (init-script "import(\"levels/hume_rainbow_cave/defualt.nut\")
wait(60)
finish_level_group(\"red\",\"r6\")")
    (ambient-light 0.6901961 0 0)
    (camera
      (mode "normal")
    )
    (candle
      (name "c0")
      (x 256)
      (y 544)
    )
    (candle
      (name "c1")
      (x 416)
      (y 544)
    )
    (candle
      (name "c2")
      (x 576)
      (y 544)
    )
    (candle
      (name "c3")
      (x 736)
      (y 544)
    )
    (candle
      (name "c4")
      (x 896)
      (y 544)
    )
    (candle
      (name "c5")
      (x 1056)
      (y 544)
    )
    (dispenser
      (badguy "snowball" "mrbomb" "spiky" "smartball" "snowball" "mrbomb" "spiky" "smartball" "snowball" "mrbomb" "spiky" "smartball" "snowball" "mrbomb" "spiky" "smartball" "snowball" "mrbomb" "spiky" "smartball" "snowball" "mrbomb" "spiky" "smartball" "captainsnowball" "totem")
      (cycle 1)
      (x 128)
      (y 224)
    )
    (platform
      (sprite "images/objects/flying_platform/flying_platform.sprite")
      (path
        (node
          (x 992)
          (y 576)
          (time 0.5)
        )
        (node
          (x 992)
          (y 288)
          (time 0.5)
        )
        (node
          (x 864)
          (y 416)
          (time 0.5)
        )
      )
    )
    (gradient
      (top_color 1 0 0)
      (bottom_color 1 0 0)
    )
    (magicblock
      (x 992)
      (y 576)
      (color 1 0 0)
    )
    (magicblock
      (x 352)
      (y 576)
      (color 1 0 0)
    )
    (magicblock
      (x 384)
      (y 576)
      (color 1 0 0)
    )
    (magicblock
      (x 416)
      (y 576)
      (color 1 0 0)
    )
    (magicblock
      (x 448)
      (y 576)
      (color 1 0 0)
    )
    (magicblock
      (x 480)
      (y 576)
      (color 1 0 0)
    )
    (magicblock
      (x 512)
      (y 576)
      (color 1 0 0)
    )
    (magicblock
      (x 544)
      (y 576)
      (color 1 0 0)
    )
    (magicblock
      (x 576)
      (y 576)
      (color 1 0 0)
    )
    (magicblock
      (x 608)
      (y 576)
      (color 1 0 0)
    )
    (magicblock
      (x 640)
      (y 576)
      (color 1 0 0)
    )
    (magicblock
      (x 672)
      (y 576)
      (color 1 0 0)
    )
    (magicblock
      (x 704)
      (y 576)
      (color 1 0 0)
    )
    (magicblock
      (x 736)
      (y 576)
      (color 1 0 0)
    )
    (magicblock
      (x 768)
      (y 576)
      (color 1 0 0)
    )
    (magicblock
      (x 800)
      (y 576)
      (color 1 0 0)
    )
    (magicblock
      (x 832)
      (y 576)
      (color 1 0 0)
    )
    (magicblock
      (x 864)
      (y 576)
      (color 1 0 0)
    )
    (magicblock
      (x 896)
      (y 576)
      (color 1 0 0)
    )
    (magicblock
      (x 928)
      (y 576)
      (color 1 0 0)
    )
    (magicblock
      (x 960)
      (y 576)
      (color 1 0 0)
    )
    (scripttrigger
      (script "Tux.kill(true)")
      (button #f)
      (width 32)
      (height 204)
      (x 640)
      (y 224)
    )
    (spawnpoint
      (name "main")
      (x 576)
      (y 320)
    )
    (tilemap
      (z-pos -100)
      (solid #f)
      (name "Background")
      (width 50)
      (height 35)
      (tiles
      1478 1478 1478 1478 1478 1478 1478 1478 1478 1478 1478 1478 1478 1478 1478 1478 1478 1478 1478 1478 1478 1478 1478 1478 1478 1478 1478 1478 1478 1478 1478 1478 1478 1478 1478 1478 1478 1478 1478 1478 1478 1478 1478 1478 1478 1478 1478 1478 1478 1478
      1478 1478 1478 1478 1478 1478 1478 1478 1478 1478 1478 1478 1478 1478 1478 1478 1478 1478 1478 1478 1478 1478 1478 1478 1478 1478 1478 1478 1478 1478 1478 1478 1478 1478 1478 1478 1478 1478 1478 1478 1478 1478 1478 1478 1478 1478 1478 1478 1478 1478
      1478 1478 1478 1478 1478 1478 1478 1478 1478 1478 1478 1478 1478 1478 1478 1478 1478 1478 1478 1478 1478 1478 1478 1478 1478 1478 1478 1478 1478 1478 1478 1478 1478 1478 1478 1478 1478 1478 1478 1478 1478 1478 1478 1478 1478 1478 1478 1478 1478 1478
      1478 1478 1478 1478 1478 1478 1478 1478 1478 1478 1478 1478 1478 1478 1478 1478 1478 1478 1478 1478 1478 1478 1478 1478 1478 1478 1478 1478 1478 1478 1478 1478 1478 1478 1478 1478 1478 1478 1478 1478 1478 1478 1478 1478 1478 1478 1478 1478 1478 1478
      1478 1478 1478 1478 1478 1478 1478 1478 1478 1478 1478 1478 1478 1478 1478 1478 1478 1478 1478 1478 1478 1478 1478 1478 1478 1478 1478 1478 1478 1478 1478 1478 1478 1478 1478 1478 1478 1478 1478 1478 1478 1478 1478 1478 1478 1478 1478 1478 1478 1478
      1478 1478 1478 1478 1478 1478 1478 1478 1478 1478 1478 1478 1478 1478 1478 1478 1478 1478 1478 1478 1478 1478 1478 1478 1478 1478 1478 1478 1478 1478 1478 1478 1478 1478 1478 1478 1478 1478 1478 1478 1478 1478 1478 1478 1478 1478 1478 1478 1478 1478
      1478 1478 1478 1478 1478 1478 1478 1478 1478 1478 1478 2647 2648 2649 2650 2647 2648 2649 2650 2647 2648 2649 2650 2647 2648 2649 2650 2647 2648 2649 2650 2647 2648 2649 2650 1478 1478 1478 1478 1478 1478 1478 1478 1478 1478 1478 1478 1478 1478 1478
      2652 2653 2654 2651 2652 2653 2654 2651 2652 2653 2654 2651 2652 2653 2654 2651 2652 2653 2654 2651 2652 2653 2654 2651 2652 2653 2654 2651 2652 2653 2654 2651 2652 2653 2654 1478 1478 1478 1478 1478 1478 1478 1478 1478 1478 1478 1478 1478 1478 1478
      2648 2649 2650 2647 2648 2649 2650 2647 2648 2649 2650 2647 2648 2649 2650 2647 2648 2649 2650 2647 2648 2649 2650 2647 2648 2649 2650 2647 2648 2649 2650 2647 2648 2649 2650 1478 1478 1478 1478 1478 1478 1478 1478 1478 1478 1478 1478 1478 1478 1478
      2652 2653 2654 2651 2652 2653 2654 2651 2652 2653 2654 2651 2652 2653 2654 2651 2652 2653 2654 2651 2652 2653 2654 2651 2652 2653 2654 2651 2652 2653 2654 2651 2652 2653 2654 1478 1478 1478 1478 1478 1478 1478 1478 1478 1478 1478 1478 1478 1478 1478
      2648 2649 2650 2647 2648 2649 2650 2647 2648 2649 2650 2647 2648 2649 2650 2647 2648 2649 2650 2647 2648 2649 2650 2647 2648 2649 2650 2647 2648 2649 2650 2647 2648 2649 2650 1478 1478 1478 1478 1478 1478 1478 1478 1478 1478 1478 1478 1478 1478 1478
      2652 2653 2654 2651 2652 2653 2654 2651 2652 2653 2654 2651 2652 2653 2654 2651 2652 2653 2654 2651 2652 2653 2654 2651 2652 2653 2654 2651 2652 2653 2654 2651 2652 2653 2654 1478 1478 1478 1478 1478 1478 1478 1478 1478 1478 1478 1478 1478 1478 1478
      2648 2649 2650 2647 2648 2649 2650 2647 2648 2649 2650 2647 2648 2649 2650 2647 2648 2649 2650 2647 2648 2649 2650 2647 2648 2649 2650 2647 2648 2649 2650 2647 2648 2649 2650 1478 1478 1478 1478 1478 1478 1478 1478 1478 1478 1478 1478 1478 1478 1478
      2652 2653 2654 2651 2652 2653 2654 2651 2652 2653 2654 2651 2652 2653 2654 2651 2652 2653 2654 2651 2652 2653 2654 2651 2652 2653 2654 2651 2652 2653 2654 2651 2652 2653 2654 1478 1478 1478 1478 1478 1478 1478 1478 1478 1478 1478 1478 1478 1478 1478
      2648 2649 2650 2647 2648 2649 2650 2647 2648 2649 2650 2647 2648 2649 2650 2647 2648 2649 2650 2647 2648 2649 2650 2647 2648 2649 2650 2647 2648 2649 2650 2647 2648 2649 2650 1478 1478 1478 1478 1478 1478 1478 1478 1478 1478 1478 1478 1478 1478 1478
      2652 2653 2654 2651 2652 2653 2654 2651 2652 2653 2654 2651 2652 2653 2654 2651 2652 2653 2654 2651 2652 2653 2654 2651 2652 2653 2654 2651 2652 2653 2654 2651 2652 2653 2654 1478 1478 1478 1478 1478 1478 1478 1478 1478 1478 1478 1478 1478 1478 1478
      2648 2649 2650 2647 2648 2649 2650 2647 2648 2649 2650 2647 2648 2649 2650 2647 2648 2649 2650 2647 2648 2649 2650 2647 2648 2649 2650 2647 2648 2649 2650 2647 2648 2649 2650 1478 1478 1478 1478 1478 1478 1478 1478 1478 1478 1478 1478 1478 1478 1478
      2652 2653 2654 2651 2652 2653 2654 2651 2652 2653 2654 2651 2652 2653 2654 2651 2652 2653 2654 2651 2652 2653 2654 2651 2652 2653 2654 2651 2652 2653 2654 2651 2652 2653 2654 1478 1478 1478 1478 1478 1478 1478 1478 1478 1478 1478 1478 1478 1478 1478
      1478 1478 1478 1478 1478 1478 1478 1478 1478 1478 1478 2647 2648 2649 2650 2647 2648 2649 2650 2647 2648 2649 2650 2647 2648 2649 2650 2647 2648 2649 2650 2647 2648 2649 2650 1478 1478 1478 1478 1478 1478 1478 1478 1478 1478 1478 1478 1478 1478 1478
      1478 1478 1478 1478 1478 1478 1478 1478 1478 1478 1478 2651 2652 2653 2654 2651 2652 2653 2654 2651 2652 2653 2654 2651 2652 2653 2654 2651 2652 2653 2654 2651 2652 2653 2654 1478 1478 1478 1478 1478 1478 1478 1478 1478 1478 1478 1478 1478 1478 1478
      1478 1478 1478 1478 1478 1478 1478 1478 1478 1478 1478 2647 2648 2649 2650 2647 2648 2649 2650 2647 2648 2649 2650 2647 2648 2649 2650 2647 2648 2649 2650 2647 2648 2649 2650 1478 1478 1478 1478 1478 1478 1478 1478 1478 1478 1478 1478 1478 1478 1478
      1478 1478 1478 1478 1478 1478 1478 1478 1478 1478 1478 2651 2652 2653 2654 2651 2652 2653 2654 2651 2652 2653 2654 2651 2652 2653 2654 2651 2652 2653 2654 2651 2652 2653 2654 1478 1478 1478 1478 1478 1478 1478 1478 1478 1478 1478 1478 1478 1478 1478
      1478 1478 1478 1478 1478 1478 1478 1478 1478 1478 1478 1478 1478 1478 1478 1478 1478 1478 1478 1478 1478 1478 1478 1478 1478 1478 1478 1478 1478 1478 1478 1478 1478 1478 1478 1478 1478 1478 1478 1478 1478 1478 1478 1478 1478 1478 1478 1478 1478 1478
      1478 1478 1478 1478 1478 1478 1478 1478 1478 1478 1478 1478 1478 1478 1478 1478 1478 1478 1478 1478 1478 1478 1478 1478 1478 1478 1478 1478 1478 1478 1478 1478 1478 1478 1478 1478 1478 1478 1478 1478 1478 1478 1478 1478 1478 1478 1478 1478 1478 1478
      1478 1478 1478 1478 1478 1478 1478 1478 1478 1478 1478 1478 1478 1478 1478 1478 1478 1478 1478 1478 1478 1478 1478 1478 1478 1478 1478 1478 1478 1478 1478 1478 1478 1478 1478 1478 1478 1478 1478 1478 1478 1478 1478 1478 1478 1478 1478 1478 1478 1478
      1478 1478 1478 1478 1478 1478 1478 1478 1478 1478 1478 1478 1478 1478 1478 1478 1478 1478 1478 1478 1478 1478 1478 1478 1478 1478 1478 1478 1478 1478 1478 1478 1478 1478 1478 1478 1478 1478 1478 1478 1478 1478 1478 1478 1478 1478 1478 1478 1478 1478
      1478 1478 1478 1478 1478 1478 1478 1478 1478 1478 1478 1478 1478 1478 1478 1478 1478 1478 1478 1478 1478 1478 1478 1478 1478 1478 1478 1478 1478 1478 1478 1478 1478 1478 1478 1478 1478 1478 1478 1478 1478 1478 1478 1478 1478 1478 1478 1478 1478 1478
      1478 1478 1478 1478 1478 1478 1478 1478 1478 1478 1478 1478 1478 1478 1478 1478 1478 1478 1478 1478 1478 1478 1478 1478 1478 1478 1478 1478 1478 1478 1478 1478 1478 1478 1478 1478 1478 1478 1478 1478 1478 1478 1478 1478 1478 1478 1478 1478 1478 1478
      1478 1478 1478 1478 1478 1478 1478 1478 1478 1478 1478 1478 1478 1478 1478 1478 1478 1478 1478 1478 1478 1478 1478 1478 1478 1478 1478 1478 1478 1478 1478 1478 1478 1478 1478 1478 1478 1478 1478 1478 1478 1478 1478 1478 1478 1478 1478 1478 1478 1478
      1478 1478 1478 1478 1478 1478 1478 1478 1478 1478 1478 1478 1478 1478 1478 1478 1478 1478 1478 1478 1478 1478 1478 1478 1478 1478 1478 1478 1478 1478 1478 1478 1478 1478 1478 1478 1478 1478 1478 1478 1478 1478 1478 1478 1478 1478 1478 1478 1478 1478
      1478 1478 1478 1478 1478 1478 1478 1478 1478 1478 1478 1478 1478 1478 1478 1478 1478 1478 1478 1478 1478 1478 1478 1478 1478 1478 1478 1478 1478 1478 1478 1478 1478 1478 1478 1478 1478 1478 1478 1478 1478 1478 1478 1478 1478 1478 1478 1478 1478 1478
      1478 1478 1478 1478 1478 1478 1478 1478 1478 1478 1478 1478 1478 1478 1478 1478 1478 1478 1478 1478 1478 1478 1478 1478 1478 1478 1478 1478 1478 1478 1478 1478 1478 1478 1478 1478 1478 1478 1478 1478 1478 1478 1478 1478 1478 1478 1478 1478 1478 1478
      1478 1478 1478 1478 1478 1478 1478 1478 1478 1478 1478 1478 1478 1478 1478 1478 1478 1478 1478 1478 1478 1478 1478 1478 1478 1478 1478 1478 1478 1478 1478 1478 1478 1478 1478 1478 1478 1478 1478 1478 1478 1478 1478 1478 1478 1478 1478 1478 1478 1478
      1478 1478 1478 1478 1478 1478 1478 1478 1478 1478 1478 1478 1478 1478 1478 1478 1478 1478 1478 1478 1478 1478 1478 1478 1478 1478 1478 1478 1478 1478 1478 1478 1478 1478 1478 1478 1478 1478 1478 1478 1478 1478 1478 1478 1478 1478 1478 1478 1478 1478
      1478 1478 1478 1478 1478 1478 1478 1478 1478 1478 1478 1478 1478 1478 1478 1478 1478 1478 1478 1478 1478 1478 1478 1478 1478 1478 1478 1478 1478 1478 1478 1478 1478 1478 1478 1478 1478 1478 1478 1478 1478 1478 1478 1478 1478 1478 1478 1478 1478 1478
      )
    )
    (tilemap
      (z-pos 0)
      (solid #t)
      (name "Interactive")
      (width 50)
      (height 35)
      (tiles
      1477 1477 1477 1477 1477 1477 1477 1477 1477 1477 1477 1477 1477 1477 1477 1477 1477 1477 1477 1477 1477 1477 1477 1477 1477 1477 1477 1477 1477 1477 1477 1477 1477 1477 1477 1477 1477 1477 1477 1477 1477 1477 1477 1477 1477 1477 1477 1477 1477 1477
      1477 1477 1477 1477 1477 1477 1477 1477 1477 1477 1477 1477 1477 1477 1477 1477 1477 1477 1477 1477 1477 1477 1477 1477 1477 1477 1477 1477 1477 1477 1477 1477 1477 1477 1477 1477 1477 1477 1477 1477 1477 1477 1477 1477 1477 1477 1477 1477 1477 1477
      1477 1477 1477 1477 1477 1477 1477 1477 1477 1477 1477 1477 1477 1477 1477 1477 1477 1477 1477 1477 1477 1477 1477 1477 1477 1477 1477 1477 1477 1477 1477 1477 1477 1477 1477 1477 1477 1477 1477 1477 1477 1477 1477 1477 1477 1477 1477 1477 1477 1477
      1477 1477 1477 1477 1477 1477 1477 1477 1477 1477 1477 1477 1477 1477 1477 1477 1477 1477 1477 1477 1477 1477 1477 1477 1477 1477 1477 1477 1477 1477 1477 1477 1477 1477 1477 1477 1477 1477 1477 1477 1477 1477 1477 1477 1477 1477 1477 1477 1477 1477
      1477 1477 1477 1477 1477 1477 1477 1477 1477 1477 1477 1477 1477 1477 1477 1477 1477 1477 1477 1477 1477 1477 1477 1477 1477 1477 1477 1477 1477 1477 1477 1477 1477 1477 1477 1477 1477 1477 1477 1477 1477 1477 1477 1477 1477 1477 1477 1477 1477 1477
      1477 1477 1477 1477 1477 1477 1477 1477 1477 1477 1477 1477 1477 1477 1477 1477 1477 1477 1477 1477 1477 1477 1477 1477 1477 1477 1477 1477 1477 1477 1477 1477 1477 1477 1477 1477 1477 1477 1477 1477 1477 1477 1477 1477 1477 1477 1477 1477 1477 1477
      1477 1477 1477 1477 1477 1477 1477 1477 1477 1477 1477 1477 1477 1477 1477 1477 1477 1477 1477 1477 1477 1477 1477 1477 1477 1477 1477 1477 1477 1477 1477 1477 1477 1477 1477 1477 1477 1477 1477 1477 1477 1477 1477 1477 1477 1477 1477 1477 1477 1477
      0 0 0 0 0 0 0 0 0 1477 296 0 0 0 0 0 0 0 0 0 0 0 0 0 0 0 0 0 0 0 0 0 0 0 0 1477 1477 1477 1477 1477 1477 1477 1477 1477 1477 1477 1477 1477 1477 1477
      0 0 0 0 0 0 0 0 0 1477 296 0 0 0 0 0 0 0 0 0 0 0 0 0 0 0 0 0 0 0 0 0 0 0 0 1477 1477 1477 1477 1477 1477 1477 1477 1477 1477 1477 1477 1477 1477 1477
      0 0 0 0 0 0 0 0 0 1477 296 0 0 0 0 0 0 0 0 0 0 0 0 0 0 0 0 0 0 0 0 0 0 0 0 1477 1477 1477 1477 1477 1477 1477 1477 1477 1477 1477 1477 1477 1477 1477
      0 0 0 0 0 0 0 0 0 1477 296 0 0 0 0 0 0 0 0 0 0 0 0 0 0 0 0 0 0 0 0 0 0 0 0 1477 1477 1477 1477 1477 1477 1477 1477 1477 1477 1477 1477 1477 1477 1477
      0 0 0 0 0 0 0 0 0 1477 296 0 0 0 0 0 0 0 0 0 0 0 0 0 0 0 0 0 0 0 0 0 0 0 0 1477 1477 1477 1477 1477 1477 1477 1477 1477 1477 1477 1477 1477 1477 1477
      0 0 0 0 0 0 0 0 0 1477 296 0 0 0 0 0 0 0 0 0 0 0 0 0 0 0 0 0 0 0 0 0 0 0 0 1477 1477 1477 1477 1477 1477 1477 1477 1477 1477 1477 1477 1477 1477 1477
      0 0 0 0 0 0 0 0 0 1477 1477 1477 1477 1477 1477 1477 1477 1477 1477 1477 1477 1477 1477 1477 1477 1477 1477 1477 1477 1477 1477 0 0 0 0 1477 1477 1477 1477 1477 1477 1477 1477 1477 1477 1477 1477 1477 1477 1477
      0 0 0 0 0 0 0 0 0 0 0 0 0 0 0 0 0 0 0 0 0 0 0 0 0 0 0 0 0 0 0 0 0 0 0 1477 1477 1477 1477 1477 1477 1477 1477 1477 1477 1477 1477 1477 1477 1477
      0 0 0 0 0 0 0 0 0 0 0 0 0 0 0 0 0 0 0 0 0 0 0 0 0 0 0 0 0 0 0 0 0 0 0 1477 1477 1477 1477 1477 1477 1477 1477 1477 1477 1477 1477 1477 1477 1477
      0 0 0 0 0 0 0 0 0 0 0 0 0 0 0 0 0 0 0 0 0 0 0 0 0 0 0 0 0 0 0 0 0 0 0 1477 1477 1477 1477 1477 1477 1477 1477 1477 1477 1477 1477 1477 1477 1477
      0 0 0 0 0 0 0 0 0 0 0 0 0 0 0 0 0 0 0 0 0 0 0 0 0 0 0 0 0 0 0 0 0 0 0 1477 1477 1477 1477 1477 1477 1477 1477 1477 1477 1477 1477 1477 1477 1477
      1477 1477 1477 1477 1477 1477 1477 1477 1477 1477 1477 48 48 48 48 48 48 48 48 48 48 48 48 48 48 48 48 48 48 48 48 48 1477 1477 1477 1477 1477 1477 1477 1477 1477 1477 1477 1477 1477 1477 1477 1477 1477 1477
      1477 1477 1477 1477 1477 1477 1477 1477 1477 1477 1477 0 0 0 0 0 0 0 0 0 0 0 0 0 0 0 0 0 0 0 0 0 1477 1477 1477 1477 1477 1477 1477 1477 1477 1477 1477 1477 1477 1477 1477 1477 1477 1477
      1477 1477 1477 1477 1477 1477 1477 1477 1477 1477 1477 0 0 0 0 0 0 0 0 0 0 0 0 0 0 0 0 0 0 0 0 0 1477 1477 1477 1477 1477 1477 1477 1477 1477 1477 1477 1477 1477 1477 1477 1477 1477 1477
      1477 1477 1477 1477 1477 1477 1477 1477 1477 1477 1477 295 295 295 295 295 295 295 295 295 295 295 295 295 295 295 295 295 295 295 295 295 1477 1477 1477 1477 1477 1477 1477 1477 1477 1477 1477 1477 1477 1477 1477 1477 1477 1477
      1477 1477 1477 1477 1477 1477 1477 1477 1477 1477 1477 1477 1477 1477 1477 1477 1477 1477 1477 1477 1477 1477 1477 1477 1477 1477 1477 1477 1477 1477 1477 1477 1477 1477 1477 1477 1477 1477 1477 1477 1477 1477 1477 1477 1477 1477 1477 1477 1477 1477
      1477 1477 1477 1477 1477 1477 1477 1477 1477 1477 1477 1477 1477 1477 1477 1477 1477 1477 1477 1477 1477 1477 1477 1477 1477 1477 1477 1477 1477 1477 1477 1477 1477 1477 1477 1477 1477 1477 1477 1477 1477 1477 1477 1477 1477 1477 1477 1477 1477 1477
      1477 1477 1477 1477 1477 1477 1477 1477 1477 1477 1477 1477 1477 1477 1477 1477 1477 1477 1477 1477 1477 1477 1477 1477 1477 1477 1477 1477 1477 1477 1477 1477 1477 1477 1477 1477 1477 1477 1477 1477 1477 1477 1477 1477 1477 1477 1477 1477 1477 1477
      1477 1477 1477 1477 1477 1477 1477 1477 1477 1477 1477 1477 1477 1477 1477 1477 1477 1477 1477 1477 1477 1477 1477 1477 1477 1477 1477 1477 1477 1477 1477 1477 1477 1477 1477 1477 1477 1477 1477 1477 1477 1477 1477 1477 1477 1477 1477 1477 1477 1477
      1477 1477 1477 1477 1477 1477 1477 1477 1477 1477 1477 1477 1477 1477 1477 1477 1477 1477 1477 1477 1477 1477 1477 1477 1477 1477 1477 1477 1477 1477 1477 1477 1477 1477 1477 1477 1477 1477 1477 1477 1477 1477 1477 1477 1477 1477 1477 1477 1477 1477
      1477 1477 1477 1477 1477 1477 1477 1477 1477 1477 1477 1477 1477 1477 1477 1477 1477 1477 1477 1477 1477 1477 1477 1477 1477 1477 1477 1477 1477 1477 1477 1477 1477 1477 1477 1477 1477 1477 1477 1477 1477 1477 1477 1477 1477 1477 1477 1477 1477 1477
      1477 1477 1477 1477 1477 1477 1477 1477 1477 1477 1477 1477 1477 1477 1477 1477 1477 1477 1477 1477 1477 1477 1477 1477 1477 1477 1477 1477 1477 1477 1477 1477 1477 1477 1477 1477 1477 1477 1477 1477 1477 1477 1477 1477 1477 1477 1477 1477 1477 1477
      1477 1477 1477 1477 1477 1477 1477 1477 1477 1477 1477 1477 1477 1477 1477 1477 1477 1477 1477 1477 1477 1477 1477 1477 1477 1477 1477 1477 1477 1477 1477 1477 1477 1477 1477 1477 1477 1477 1477 1477 1477 1477 1477 1477 1477 1477 1477 1477 1477 1477
      1477 1477 1477 1477 1477 1477 1477 1477 1477 1477 1477 1477 1477 1477 1477 1477 1477 1477 1477 1477 1477 1477 1477 1477 1477 1477 1477 1477 1477 1477 1477 1477 1477 1477 1477 1477 1477 1477 1477 1477 1477 1477 1477 1477 1477 1477 1477 1477 1477 1477
      1477 1477 1477 1477 1477 1477 1477 1477 1477 1477 1477 1477 1477 1477 1477 1477 1477 1477 1477 1477 1477 1477 1477 1477 1477 1477 1477 1477 1477 1477 1477 1477 1477 1477 1477 1477 1477 1477 1477 1477 1477 1477 1477 1477 1477 1477 1477 1477 1477 1477
      1477 1477 1477 1477 1477 1477 1477 1477 1477 1477 1477 1477 1477 1477 1477 1477 1477 1477 1477 1477 1477 1477 1477 1477 1477 1477 1477 1477 1477 1477 1477 1477 1477 1477 1477 1477 1477 1477 1477 1477 1477 1477 1477 1477 1477 1477 1477 1477 1477 1477
      1477 1477 1477 1477 1477 1477 1477 1477 1477 1477 1477 1477 1477 1477 1477 1477 1477 1477 1477 1477 1477 1477 1477 1477 1477 1477 1477 1477 1477 1477 1477 1477 1477 1477 1477 1477 1477 1477 1477 1477 1477 1477 1477 1477 1477 1477 1477 1477 1477 1477
      1477 1477 1477 1477 1477 1477 1477 1477 1477 1477 1477 1477 1477 1477 1477 1477 1477 1477 1477 1477 1477 1477 1477 1477 1477 1477 1477 1477 1477 1477 1477 1477 1477 1477 1477 1477 1477 1477 1477 1477 1477 1477 1477 1477 1477 1477 1477 1477 1477 1477
      )
    )
    (tilemap
      (z-pos 100)
      (solid #f)
      (name "Foreground")
      (width 50)
      (height 35)
      (tiles
      0 0 0 0 0 0 0 0 0 0 0 0 0 0 0 0 0 0 0 0 0 0 0 0 0 0 0 0 0 0 0 0 0 0 0 0 0 0 0 0 0 0 0 0 0 0 0 0 0 0
      0 0 0 0 0 0 0 0 0 0 0 0 0 0 0 0 0 0 0 0 0 0 0 0 0 0 0 0 0 0 0 0 0 0 0 0 0 0 0 0 0 0 0 0 0 0 0 0 0 0
      0 0 0 0 0 0 0 0 0 0 0 0 0 0 0 0 0 0 0 0 0 0 0 0 0 0 0 0 0 0 0 0 0 0 0 0 0 0 0 0 0 0 0 0 0 0 0 0 0 0
      0 0 0 0 0 0 0 0 0 0 0 0 0 0 0 0 0 0 0 0 0 0 0 0 0 0 0 0 0 0 0 0 0 0 0 0 0 0 0 0 0 0 0 0 0 0 0 0 0 0
      0 0 0 0 0 0 0 0 0 0 0 0 0 0 0 0 0 0 0 0 0 0 0 0 0 0 0 0 0 0 0 0 0 0 0 0 0 0 0 0 0 0 0 0 0 0 0 0 0 0
      0 0 0 0 0 0 0 0 0 0 0 0 0 0 0 0 0 0 0 0 0 0 0 0 0 0 0 0 0 0 0 0 0 0 0 0 0 0 0 0 0 0 0 0 0 0 0 0 0 0
      0 0 0 0 0 0 0 0 0 0 0 0 0 0 0 0 0 0 0 0 0 0 0 0 0 0 0 0 0 0 0 0 0 0 0 0 0 0 0 0 0 0 0 0 0 0 0 0 0 0
      0 0 0 0 0 0 0 0 0 0 0 0 0 0 0 0 0 0 0 0 298 296 0 0 0 0 0 0 0 0 0 0 0 0 0 0 0 0 0 0 0 0 0 0 0 0 0 0 0 0
      0 0 0 0 0 0 0 0 0 0 0 0 0 0 0 0 0 0 0 0 298 296 0 0 0 0 0 0 0 0 0 0 0 0 0 0 0 0 0 0 0 0 0 0 0 0 0 0 0 0
      0 0 0 0 0 0 0 0 0 0 0 0 0 0 0 0 0 0 0 0 298 296 0 0 0 0 0 0 0 0 0 0 0 0 0 0 0 0 0 0 0 0 0 0 0 0 0 0 0 0
      0 0 0 0 0 0 0 0 0 0 0 0 0 0 0 0 0 0 0 0 298 296 0 0 0 0 0 0 0 0 0 0 0 0 0 0 0 0 0 0 0 0 0 0 0 0 0 0 0 0
      0 0 0 0 0 0 0 0 0 0 0 0 0 0 0 0 0 0 0 0 298 296 0 0 0 0 0 0 0 0 0 0 0 0 0 0 0 0 0 0 0 0 0 0 0 0 0 0 0 0
      0 0 0 0 0 0 0 0 0 0 0 0 0 0 0 0 0 0 0 0 298 296 0 0 0 0 0 0 0 0 0 0 0 0 0 0 0 0 0 0 0 0 0 0 0 0 0 0 0 0
      0 0 0 0 0 0 0 0 0 0 0 0 0 0 0 0 0 0 0 0 0 0 0 0 0 0 0 0 0 0 0 0 0 0 0 0 0 0 0 0 0 0 0 0 0 0 0 0 0 0
      0 0 0 0 0 0 0 0 0 0 0 0 0 0 0 0 0 0 0 0 0 0 0 0 0 0 0 0 0 0 0 0 0 0 0 0 0 0 0 0 0 0 0 0 0 0 0 0 0 0
      0 0 0 0 0 0 0 0 0 0 0 0 0 0 0 0 0 0 0 0 0 0 0 0 0 0 0 0 0 0 0 0 0 0 0 0 0 0 0 0 0 0 0 0 0 0 0 0 0 0
      0 0 0 0 0 0 0 0 0 0 0 0 0 0 0 0 0 0 0 0 0 0 0 0 0 0 0 0 0 0 0 0 0 0 0 0 0 0 0 0 0 0 0 0 0 0 0 0 0 0
      0 0 0 0 0 0 0 0 0 0 0 0 0 0 0 0 0 0 0 0 0 0 0 0 0 0 0 0 0 0 0 0 0 0 0 0 0 0 0 0 0 0 0 0 0 0 0 0 0 0
      0 0 0 0 0 0 0 0 0 0 0 0 0 0 0 0 0 0 0 0 0 0 0 0 0 0 0 0 0 0 0 0 0 0 0 0 0 0 0 0 0 0 0 0 0 0 0 0 0 0
      0 0 0 0 0 0 0 0 0 0 0 0 0 0 0 0 0 0 0 0 0 0 0 0 0 0 0 0 0 0 0 0 0 0 0 0 0 0 0 0 0 0 0 0 0 0 0 0 0 0
      0 0 0 0 0 0 0 0 0 0 0 0 0 0 0 0 0 0 0 0 0 0 0 0 0 0 0 0 0 0 0 0 0 0 0 0 0 0 0 0 0 0 0 0 0 0 0 0 0 0
      0 0 0 0 0 0 0 0 0 0 0 0 0 0 0 0 0 0 0 0 0 0 0 0 0 0 0 0 0 0 0 0 0 0 0 0 0 0 0 0 0 0 0 0 0 0 0 0 0 0
      0 0 0 0 0 0 0 0 0 0 0 0 0 0 0 0 0 0 0 0 0 0 0 0 0 0 0 0 0 0 0 0 0 0 0 0 0 0 0 0 0 0 0 0 0 0 0 0 0 0
      0 0 0 0 0 0 0 0 0 0 0 0 0 0 0 0 0 0 0 0 0 0 0 0 0 0 0 0 0 0 0 0 0 0 0 0 0 0 0 0 0 0 0 0 0 0 0 0 0 0
      0 0 0 0 0 0 0 0 0 0 0 0 0 0 0 0 0 0 0 0 0 0 0 0 0 0 0 0 0 0 0 0 0 0 0 0 0 0 0 0 0 0 0 0 0 0 0 0 0 0
      0 0 0 0 0 0 0 0 0 0 0 0 0 0 0 0 0 0 0 0 0 0 0 0 0 0 0 0 0 0 0 0 0 0 0 0 0 0 0 0 0 0 0 0 0 0 0 0 0 0
      0 0 0 0 0 0 0 0 0 0 0 0 0 0 0 0 0 0 0 0 0 0 0 0 0 0 0 0 0 0 0 0 0 0 0 0 0 0 0 0 0 0 0 0 0 0 0 0 0 0
      0 0 0 0 0 0 0 0 0 0 0 0 0 0 0 0 0 0 0 0 0 0 0 0 0 0 0 0 0 0 0 0 0 0 0 0 0 0 0 0 0 0 0 0 0 0 0 0 0 0
      0 0 0 0 0 0 0 0 0 0 0 0 0 0 0 0 0 0 0 0 0 0 0 0 0 0 0 0 0 0 0 0 0 0 0 0 0 0 0 0 0 0 0 0 0 0 0 0 0 0
      0 0 0 0 0 0 0 0 0 0 0 0 0 0 0 0 0 0 0 0 0 0 0 0 0 0 0 0 0 0 0 0 0 0 0 0 0 0 0 0 0 0 0 0 0 0 0 0 0 0
      0 0 0 0 0 0 0 0 0 0 0 0 0 0 0 0 0 0 0 0 0 0 0 0 0 0 0 0 0 0 0 0 0 0 0 0 0 0 0 0 0 0 0 0 0 0 0 0 0 0
      0 0 0 0 0 0 0 0 0 0 0 0 0 0 0 0 0 0 0 0 0 0 0 0 0 0 0 0 0 0 0 0 0 0 0 0 0 0 0 0 0 0 0 0 0 0 0 0 0 0
      0 0 0 0 0 0 0 0 0 0 0 0 0 0 0 0 0 0 0 0 0 0 0 0 0 0 0 0 0 0 0 0 0 0 0 0 0 0 0 0 0 0 0 0 0 0 0 0 0 0
      0 0 0 0 0 0 0 0 0 0 0 0 0 0 0 0 0 0 0 0 0 0 0 0 0 0 0 0 0 0 0 0 0 0 0 0 0 0 0 0 0 0 0 0 0 0 0 0 0 0
      0 0 0 0 0 0 0 0 0 0 0 0 0 0 0 0 0 0 0 0 0 0 0 0 0 0 0 0 0 0 0 0 0 0 0 0 0 0 0 0 0 0 0 0 0 0 0 0 0 0
      )
    )
  )
)
