(supertux-level
  (version 2)
  (name (_ "Platforms are bringing badguys")) (license "GPL 2+ / CC-by-sa 3.0")
  (author "Hume")
  (sector
    (name "main")
    (music "music/cave.ogg")
    (init-script "import(\"levels/hume_rainbow_cave/defualt.nut\")
wait(60)
finish_level_group(\"white\",\"w6\")")
    (ambient-light 0.5019608 0.5019608 0.5019608)
    (background
      (speed 0.5)
    )
    (camera
      (mode "normal")
    )
    (dispenser
      (badguy "snowball")
      (cycle 0.5)
      (x 512)
      (y 736)
    )
    (dispenser
      (badguy "mrbomb")
      (cycle 1)
      (x 832)
      (y 736)
    )
    (dispenser
      (badguy "bouncingsnowball")
      (cycle 0.5)
      (x 1152)
      (y 736)
    )
    (platform
      (sprite "images/objects/flying_platform/flying_platform.sprite")
      (path
        (node
          (x 320)
          (y 1056)
        )
        (node
          (x 320)
          (y 576)
        )
        (node
          (x 448)
          (y 576)
        )
        (node
          (x 448)
          (y 704)
        )
        (node
          (x 320)
          (y 704)
        )
      )
    )
    (platform
      (sprite "images/objects/flying_platform/flying_platform.sprite")
      (path
        (node
          (x 640)
          (y 1056)
        )
        (node
          (x 640)
          (y 576)
        )
        (node
          (x 768)
          (y 576)
        )
        (node
          (x 768)
          (y 704)
        )
        (node
          (x 640)
          (y 704)
        )
      )
    )
    (platform
      (sprite "images/objects/flying_platform/flying_platform.sprite")
      (path
        (node
          (x 960)
          (y 1056)
        )
        (node
          (x 960)
          (y 576)
        )
        (node
          (x 832)
          (y 576)
        )
        (node
          (x 832)
          (y 704)
        )
        (node
          (x 960)
          (y 704)
        )
      )
    )
    (platform
      (sprite "images/objects/flying_platform/flying_platform.sprite")
      (path
        (node
          (x 1280)
          (y 1056)
        )
        (node
          (x 1280)
          (y 576)
        )
        (node
          (x 1152)
          (y 576)
        )
        (node
          (x 1152)
          (y 704)
        )
        (node
          (x 1280)
          (y 704)
        )
      )
    )
    (gradient
      (top_color 1 1 1)
      (bottom_color 1 1 1)
    )
    (spawnpoint
      (name "main")
      (x 864)
      (y 512)
    )
    (tilemap
      (z-pos -100)
      (solid #f)
      (name "Background")
      (width 50)
      (height 35)
      (tiles
      2647 2648 2649 2650 2647 2648 2649 2650 2647 2648 2649 2650 2647 2648 2649 2650 2647 2648 2649 2650 2647 2648 2649 2650 2647 2648 2649 2650 2647 2648 2649 2650 2647 2648 2649 2650 2647 2648 2649 2650 2647 2648 2649 2650 2647 2648 2649 2650 2647 2648
      2651 2652 2653 2654 2651 2652 2653 2654 2651 2652 2653 2654 2651 2652 2653 2654 2651 2652 2653 2654 2651 2652 2653 2654 2651 2652 2653 2654 2651 2652 2653 2654 2651 2652 2653 2654 2651 2652 2653 2654 2651 2652 2653 2654 2651 2652 2653 2654 2651 2652
      2647 2648 2649 2650 2647 2648 2649 2650 2647 2648 2649 2650 2647 2648 2649 2650 2647 2648 2649 2650 2647 2648 2649 2650 2647 2648 2649 2650 2647 2648 2649 2650 2647 2648 2649 2650 2647 2648 2649 2650 2647 2648 2649 2650 2647 2648 2649 2650 2647 2648
      2651 2652 2653 2654 2651 2652 2653 2654 2651 2652 2653 2654 2651 2652 2653 2654 2651 2652 2653 2654 2651 2652 2653 2654 2651 2652 2653 2654 2651 2652 2653 2654 2651 2652 2653 2654 2651 2652 2653 2654 2651 2652 2653 2654 2651 2652 2653 2654 2651 2652
      2647 2648 2649 2650 2647 2648 2649 2650 2647 2648 2649 2650 2647 2648 2649 2650 2647 2648 2649 2650 2647 2648 2649 2650 2647 2648 2649 2650 2647 2648 2649 2650 2647 2648 2649 2650 2647 2648 2649 2650 2647 2648 2649 2650 2647 2648 2649 2650 2647 2648
      2651 2652 2653 2654 2651 2652 2653 2654 2651 2652 2653 2654 2651 2652 2653 2654 2651 2652 2653 2654 2651 2652 2653 2654 2651 2652 2653 2654 2651 2652 2653 2654 2651 2652 2653 2654 2651 2652 2653 2654 2651 2652 2653 2654 2651 2652 2653 2654 2651 2652
      2647 2648 2649 2650 2647 2648 2649 2650 2647 2648 2649 2650 2647 2648 2649 2650 2647 2648 2649 2650 2647 2648 2649 2650 2647 2648 2649 2650 2647 2648 2649 2650 2647 2648 2649 2650 2647 2648 2649 2650 2647 2648 2649 2650 2647 2648 2649 2650 2647 2648
      2651 2652 2653 2654 2651 2652 2653 2654 2651 2652 2653 2654 2651 2652 2653 2654 2651 2652 2653 2654 2651 2652 2653 2654 2651 2652 2653 2654 2651 2652 2653 2654 2651 2652 2653 2654 2651 2652 2653 2654 2651 2652 2653 2654 2651 2652 2653 2654 2651 2652
      2647 2648 2649 2650 2647 2648 2649 2650 2647 2648 2649 2650 2647 2648 2649 2650 2647 2648 2649 2650 2647 2648 2649 2650 2647 2648 2649 2650 2647 2648 2649 2650 2647 2648 2649 2650 2647 2648 2649 2650 2647 2648 2649 2650 2647 2648 2649 2650 2647 2648
      2651 2652 2653 2654 2651 2652 2653 2654 2651 2652 2653 2654 2651 2652 2653 2654 2651 2652 2653 2654 2651 2652 2653 2654 2651 2652 2653 2654 2651 2652 2653 2654 2651 2652 2653 2654 2651 2652 2653 2654 2651 2652 2653 2654 2651 2652 2653 2654 2651 2652
      2647 2648 2649 2650 2647 2648 2649 2650 2647 2648 2649 2650 2647 2648 2649 2650 2647 2648 2649 2650 2647 2648 2649 2650 2647 2648 2649 2650 2647 2648 2649 2650 2647 2648 2649 2650 2647 2648 2649 2650 2647 2648 2649 2650 2647 2648 2649 2650 2647 2648
      2651 2652 2653 2654 2651 2652 2653 2654 2651 2652 2653 2654 2651 2652 2653 2654 2651 2652 2653 2654 2651 2652 2653 2654 2651 2652 2653 2654 2651 2652 2653 2654 2651 2652 2653 2654 2651 2652 2653 2654 2651 2652 2653 2654 2651 2652 2653 2654 2651 2652
      2647 2648 2649 2650 2647 2648 2649 2650 2647 2648 2649 2650 2647 2648 2649 2650 2647 2648 2649 2650 2647 2648 2649 2650 2647 2648 2649 2650 2647 2648 2649 2650 2647 2648 2649 2650 2647 2648 2649 2650 2647 2648 2649 2650 2647 2648 2649 2650 2647 2648
      2651 2652 2653 2654 2651 2652 2653 2654 2651 2652 2653 2654 2651 2652 2653 2654 2651 2652 2653 2654 2651 2652 2653 2654 2651 2652 2653 2654 2651 2652 2653 2654 2651 2652 2653 2654 2651 2652 2653 2654 2651 2652 2653 2654 2651 2652 2653 2654 2651 2652
      2647 2648 2649 2650 2647 2648 2649 2650 2647 2648 2649 2650 2647 2648 2649 2650 2647 2648 2649 2650 2647 2648 2649 2650 2647 2648 2649 2650 2647 2648 2649 2650 2647 2648 2649 2650 2647 2648 2649 2650 2647 2648 2649 2650 2647 2648 2649 2650 2647 2648
      2651 2652 2653 2654 2651 2652 2653 2654 2651 2652 2653 2654 2651 2652 2653 2654 2651 2652 2653 2654 2651 2652 2653 2654 2651 2652 2653 2654 2651 2652 2653 2654 2651 2652 2653 2654 2651 2652 2653 2654 2651 2652 2653 2654 2651 2652 2653 2654 2651 2652
      2647 2648 2649 2650 2647 2648 2649 2650 2647 2648 2649 2650 2647 2648 2649 2650 2647 2648 2649 2650 2647 2648 2649 2650 2647 2648 2649 2650 2647 2648 2649 2650 2647 2648 2649 2650 2647 2648 2649 2650 2647 2648 2649 2650 2647 2648 2649 2650 2647 2648
      2651 2652 2653 2654 2651 2652 2653 2654 2651 2652 2653 2654 2651 2652 2653 2654 2651 2652 2653 2654 2651 2652 2653 2654 2651 2652 2653 2654 2651 2652 2653 2654 2651 2652 2653 2654 2651 2652 2653 2654 2651 2652 2653 2654 2651 2652 2653 2654 2651 2652
      2647 2648 2649 2650 2647 2648 2649 2650 2647 2648 2649 2650 2647 2648 2649 2650 2647 2648 2649 2650 2647 2648 2649 2650 2647 2648 2649 2650 2647 2648 2649 2650 2647 2648 2649 2650 2647 2648 2649 2650 2647 2648 2649 2650 2647 2648 2649 2650 2647 2648
      2651 2652 2653 2654 2651 2652 2653 2654 2651 2652 2653 2654 2651 2652 2653 2654 2651 2652 2653 2654 2651 2652 2653 2654 2651 2652 2653 2654 2651 2652 2653 2654 2651 2652 2653 2654 2651 2652 2653 2654 2651 2652 2653 2654 2651 2652 2653 2654 2651 2652
      2647 2648 2649 2650 2647 2648 2649 2650 2647 2648 2649 2650 2647 2648 2649 2650 2647 2648 2649 2650 2647 2648 2649 2650 2647 2648 2649 2650 2647 2648 2649 2650 2647 2648 2649 2650 2647 2648 2649 2650 2647 2648 2649 2650 2647 2648 2649 2650 2647 2648
      2651 2652 2653 2654 2651 2652 2653 2654 2651 2652 2653 2654 2651 2652 2653 2654 2651 2652 2653 2654 2651 2652 2653 2654 2651 2652 2653 2654 2651 2652 2653 2654 2651 2652 2653 2654 2651 2652 2653 2654 2651 2652 2653 2654 2651 2652 2653 2654 2651 2652
      2647 2648 2649 2650 2647 2648 2649 2650 2647 2648 2649 2650 2647 2648 2649 2650 2647 2648 2649 2650 2647 2648 2649 2650 2647 2648 2649 2650 2647 2648 2649 2650 2647 2648 2649 2650 2647 2648 2649 2650 2647 2648 2649 2650 2647 2648 2649 2650 2647 2648
      2651 2652 2653 2654 2651 2652 2653 2654 2651 2652 2653 2654 2651 2652 2653 2654 2651 2652 2653 2654 2651 2652 2653 2654 2651 2652 2653 2654 2651 2652 2653 2654 2651 2652 2653 2654 2651 2652 2653 2654 2651 2652 2653 2654 2651 2652 2653 2654 2651 2652
      2647 2648 2649 2650 2647 2648 2649 2650 2647 2648 2649 2650 2647 2648 2649 2650 2647 2648 2649 2650 2647 2648 2649 2650 2647 2648 2649 2650 2647 2648 2649 2650 2647 2648 2649 2650 2647 2648 2649 2650 2647 2648 2649 2650 2647 2648 2649 2650 2647 2648
      2651 2652 2653 2654 2651 2652 2653 2654 2651 2652 2653 2654 2651 2652 2653 2654 2651 2652 2653 2654 2651 2652 2653 2654 2651 2652 2653 2654 2651 2652 2653 2654 2651 2652 2653 2654 2651 2652 2653 2654 2651 2652 2653 2654 2651 2652 2653 2654 2651 2652
      2647 2648 2649 2650 2647 2648 2649 2650 2647 2648 2649 2650 2647 2648 2649 2650 2647 2648 2649 2650 2647 2648 2649 2650 2647 2648 2649 2650 2647 2648 2649 2650 2647 2648 2649 2650 2647 2648 2649 2650 2647 2648 2649 2650 2647 2648 2649 2650 2647 2648
      2651 2652 2653 2654 2651 2652 2653 2654 2651 2652 2653 2654 2651 2652 2653 2654 2651 2652 2653 2654 2651 2652 2653 2654 2651 2652 2653 2654 2651 2652 2653 2654 2651 2652 2653 2654 2651 2652 2653 2654 2651 2652 2653 2654 2651 2652 2653 2654 2651 2652
      2647 2648 2649 2650 2647 2648 2649 2650 2647 2648 2649 2650 2647 2648 2649 2650 2647 2648 2649 2650 2647 2648 2649 2650 2647 2648 2649 2650 2647 2648 2649 2650 2647 2648 2649 2650 2647 2648 2649 2650 2647 2648 2649 2650 2647 2648 2649 2650 2647 2648
      2651 2652 2653 2654 2651 2652 2653 2654 2651 2652 2653 2654 2651 2652 2653 2654 2651 2652 2653 2654 2651 2652 2653 2654 2651 2652 2653 2654 2651 2652 2653 2654 2651 2652 2653 2654 2651 2652 2653 2654 2651 2652 2653 2654 2651 2652 2653 2654 2651 2652
      2647 2648 2649 2650 2647 2648 2649 2650 2647 2648 2649 2650 2647 2648 2649 2650 2647 2648 2649 2650 2647 2648 2649 2650 2647 2648 2649 2650 2647 2648 2649 2650 2647 2648 2649 2650 2647 2648 2649 2650 2647 2648 2649 2650 2647 2648 2649 2650 2647 2648
      2651 2652 2653 2654 2651 2652 2653 2654 2651 2652 2653 2654 2651 2652 2653 2654 2651 2652 2653 2654 2651 2652 2653 2654 2651 2652 2653 2654 2651 2652 2653 2654 2651 2652 2653 2654 2651 2652 2653 2654 2651 2652 2653 2654 2651 2652 2653 2654 2651 2652
      2647 2648 2649 2650 2647 2648 2649 2650 2647 2648 2649 2650 2647 2648 2649 2650 2647 2648 2649 2650 2647 2648 2649 2650 2647 2648 2649 2650 2647 2648 2649 2650 2647 2648 2649 2650 2647 2648 2649 2650 2647 2648 2649 2650 2647 2648 2649 2650 2647 2648
      2651 2652 2653 2654 2651 2652 2653 2654 2651 2652 2653 2654 2651 2652 2653 2654 2651 2652 2653 2654 2651 2652 2653 2654 2651 2652 2653 2654 2651 2652 2653 2654 2651 2652 2653 2654 2651 2652 2653 2654 2651 2652 2653 2654 2651 2652 2653 2654 2651 2652
      2647 2648 2649 2650 2647 2648 2649 2650 2647 2648 2649 2650 2647 2648 2649 2650 2647 2648 2649 2650 2647 2648 2649 2650 2647 2648 2649 2650 2647 2648 2649 2650 2647 2648 2649 2650 2647 2648 2649 2650 2647 2648 2649 2650 2647 2648 2649 2650 2647 2648
      )
    )
    (tilemap
      (z-pos 0)
      (solid #t)
      (name "Interactive")
      (width 50)
      (height 35)
      (tiles
      2479 2479 2479 2479 2479 2479 2479 2479 2479 2479 2479 2479 2479 2479 2479 2479 2479 2479 2479 2479 2479 2479 2479 2479 2479 2479 2479 2479 2479 2479 2479 2479 2479 2479 2479 2479 2479 2479 2479 2479 2479 2479 2479 2479 2479 2479 2479 2479 2479 2479
      2479 2479 2479 2479 2479 2479 2479 2479 2479 2479 2479 2479 2479 2479 2479 2479 2479 2479 2479 2479 2479 2479 2479 2479 2479 2479 2479 2479 2479 2479 2479 2479 2479 2479 2479 2479 2479 2479 2479 2479 2479 2479 2479 2479 2479 2479 2479 2479 2479 2479
      2479 2479 2479 2479 2479 2479 2479 2479 2479 2479 2479 2479 2479 2479 2479 2479 2479 2479 2479 2479 2479 2479 2479 2479 2479 2479 2479 2479 2479 2479 2479 2479 2479 2479 2479 2479 2479 2479 2479 2479 2479 2479 2479 2479 2479 2479 2479 2479 2479 2479
      2479 2479 2479 2479 2479 2479 2479 2479 2471 2472 2507 2508 2507 2508 2507 2508 2507 2508 2507 2508 2507 2508 2507 2508 2507 2508 2507 2508 2507 2508 2507 2508 2507 2508 2507 2508 2507 2508 2507 2508 2507 2508 2507 2508 2469 2470 2479 2479 2479 2479
      2479 2479 2479 2479 2479 2479 2479 2479 2485 2486 0 0 0 0 0 0 0 0 0 0 0 0 0 0 0 0 0 0 0 0 0 0 0 0 0 0 0 0 0 0 0 0 0 0 2483 2484 2479 2479 2479 2479
      2479 2479 2479 2479 2479 2479 2479 2479 2499 2500 0 0 0 0 0 0 0 0 0 0 0 0 0 0 0 0 0 0 0 0 0 0 0 0 0 0 0 0 0 0 0 0 0 0 2497 2498 2479 2479 2479 2479
      2479 2479 2479 2479 2479 2479 2479 2479 2513 2514 0 0 0 0 0 0 0 0 0 0 0 0 0 0 0 0 0 0 0 0 0 0 0 0 0 0 0 0 0 0 0 0 0 0 2511 2512 2479 2479 2479 2479
      2479 2479 2479 2479 2479 2479 2479 2479 2467 2468 0 0 0 0 0 0 0 0 0 0 0 0 0 0 0 0 0 0 0 0 0 0 0 0 0 0 0 0 0 0 0 0 0 0 2491 2492 2479 2479 2479 2479
      2479 2479 2479 2479 2479 2479 2479 2479 2481 2482 0 0 0 0 0 0 0 0 0 0 0 0 0 0 0 0 0 0 0 0 0 0 0 0 0 0 0 0 0 0 0 0 0 0 2463 2464 2479 2479 2479 2479
      2479 2479 2479 2479 2479 2479 2479 2479 2495 2496 0 0 0 0 0 0 0 0 0 0 0 0 0 0 0 0 0 0 0 0 0 0 0 0 0 0 0 0 0 0 0 0 0 0 2477 2478 2479 2479 2479 2479
      2479 2479 2479 2479 2479 2479 2479 2479 2467 2468 0 0 0 0 0 0 0 0 0 0 0 0 0 0 0 0 0 0 0 0 0 0 0 0 0 0 0 0 0 0 0 0 0 0 2491 2492 2479 2479 2479 2479
      2479 2479 2479 2479 2479 2479 2479 2479 2481 2482 0 0 0 0 0 0 0 0 0 0 0 0 0 0 0 0 0 0 0 0 0 0 0 0 0 0 0 0 0 0 0 0 0 0 2463 2464 2479 2479 2479 2479
      2479 2479 2479 2479 2479 2479 2479 2479 2495 2496 0 0 0 0 0 0 0 0 0 0 0 0 0 0 0 0 0 0 0 0 0 0 0 0 0 0 0 0 0 0 0 0 0 0 2477 2478 2479 2479 2479 2479
      2479 2479 2479 2479 2479 2479 2479 2479 2467 2468 0 0 0 0 0 0 0 0 0 0 0 0 0 0 0 0 0 0 0 0 0 0 0 0 0 0 0 0 0 0 0 0 0 0 2491 2492 2479 2479 2479 2479
      2479 2479 2479 2479 2479 2479 2479 2479 2481 2482 0 0 0 0 0 0 0 0 0 0 0 0 0 0 0 0 0 0 0 0 0 0 0 0 0 0 0 0 0 0 0 0 0 0 2463 2464 2479 2479 2479 2479
      2479 2479 2479 2479 2479 2479 2479 2479 2495 2496 0 0 0 0 0 0 0 0 0 0 0 0 0 0 0 0 0 0 0 0 0 0 0 0 0 0 0 0 0 0 0 0 0 0 2477 2478 2479 2479 2479 2479
      2479 2479 2479 2479 2479 2479 2479 2479 2467 2468 0 0 0 0 0 0 0 0 0 0 0 0 0 0 0 0 0 0 0 0 0 0 0 0 0 0 0 0 0 0 0 0 0 0 2491 2492 2479 2479 2479 2479
      2479 2479 2479 2479 2479 2479 2479 2479 2481 2482 0 0 0 0 2421 2422 2423 2424 2425 2426 0 0 0 0 2421 2422 2423 2424 2425 2426 0 0 0 0 2421 2422 2423 2424 2425 2426 0 0 0 0 2463 2464 2479 2479 2479 2479
      2479 2479 2479 2479 2479 2479 2479 2479 2495 2496 2155 2156 2156 2157 2435 2436 2437 2438 2439 2440 2155 2156 2156 2157 2435 2436 2437 2438 2439 2440 2155 2156 2156 2157 2435 2436 2437 2438 2439 2440 2155 2156 2156 2157 2477 2478 2479 2479 2479 2479
      2479 2479 2479 2479 2479 2479 2479 2479 2467 2468 0 0 0 0 2449 2450 2451 2452 2453 2454 0 0 0 0 2449 2450 2451 2452 2453 2454 0 0 0 0 2449 2450 2451 2452 2453 2454 0 0 0 0 2491 2492 2479 2479 2479 2479
      2479 2479 2479 2479 2479 2479 2479 2479 2481 2482 0 0 0 0 2463 2464 2479 2479 2467 2468 0 0 0 0 2463 2464 2479 2479 2467 2468 0 0 0 0 2463 2464 2479 2479 2467 2468 0 0 0 0 2463 2464 2479 2479 2479 2479
      2479 2479 2479 2479 2479 2479 2479 2479 2495 2496 0 0 0 0 2477 2478 2479 2479 2481 2482 0 0 0 0 2477 2478 2479 2479 2481 2482 0 0 0 0 2477 2478 2479 2479 2481 2482 0 0 0 0 2477 2478 2479 2479 2479 2479
      2479 2479 2479 2479 2479 2479 2479 2479 2467 2468 0 0 0 0 2491 2472 2507 2508 2469 2496 0 0 0 0 2491 2472 2507 2508 2469 2496 0 0 0 0 2491 2472 2507 2508 2469 2496 0 0 0 0 2491 2492 2479 2479 2479 2479
      2479 2479 2479 2479 2479 2479 2479 2479 2481 2482 0 0 0 0 2463 2486 0 0 2483 2468 0 0 0 0 2463 2486 0 0 2483 2468 0 0 0 0 2463 2486 0 0 2483 2468 0 0 0 0 2463 2464 2479 2479 2479 2479
      2479 2479 2479 2479 2479 2479 2479 2479 2495 2496 0 0 0 0 2477 2500 0 0 2497 2482 0 0 0 0 2477 2500 0 0 2497 2482 0 0 0 0 2477 2500 0 0 2497 2482 0 0 0 0 2477 2478 2479 2479 2479 2479
      2479 2479 2479 2479 2479 2479 2479 2479 2467 2468 0 0 0 0 2491 2514 0 0 2511 2496 0 0 0 0 2491 2514 0 0 2511 2496 0 0 0 0 2491 2514 0 0 2511 2496 0 0 0 0 2491 2492 2479 2479 2479 2479
      2479 2479 2479 2479 2479 2479 2479 2479 2481 2482 0 0 0 0 2463 2486 0 0 2463 2486 0 0 0 0 2463 2486 0 0 2463 2486 0 0 0 0 2463 2486 0 0 2463 2486 0 0 0 0 2463 2464 2479 2479 2479 2479
      2479 2479 2479 2479 2479 2479 2479 2479 2495 2496 0 0 0 0 2477 2500 0 0 2477 2500 0 0 0 0 2477 2500 0 0 2477 2500 0 0 0 0 2477 2500 0 0 2477 2500 0 0 0 0 2477 2478 2479 2479 2479 2479
      2479 2479 2479 2479 2479 2479 2479 2479 2467 2468 0 0 0 0 2491 2514 0 0 2491 2514 0 0 0 0 2491 2514 0 0 2491 2514 0 0 0 0 2491 2514 0 0 2491 2514 0 0 0 0 2491 2492 2479 2479 2479 2479
      2479 2479 2479 2479 2479 2479 2479 2479 2481 2482 0 0 0 0 2505 2510 0 0 2505 2510 0 0 0 0 2505 2510 0 0 2505 2510 0 0 0 0 2505 2510 0 0 2505 2510 0 0 0 0 2463 2464 2479 2479 2479 2479
      2479 2479 2479 2479 2479 2479 2479 2479 2495 2496 0 0 0 0 0 0 0 0 0 0 0 0 0 0 0 0 0 0 0 0 0 0 0 0 0 0 0 0 0 0 0 0 0 0 2477 2478 2479 2479 2479 2479
      2479 2479 2479 2479 2479 2479 2479 2479 2415 2416 0 0 0 0 0 0 0 0 0 0 0 0 0 0 0 0 0 0 0 0 0 0 0 0 0 0 0 0 0 0 0 0 0 0 2491 2492 2479 2479 2479 2479
      2479 2479 2479 2479 2479 2479 2479 2479 2429 2430 2423 2424 2423 2424 2423 2424 2423 2424 2423 2424 2423 2424 2423 2424 2423 2424 2423 2424 2423 2424 2423 2424 2423 2424 2423 2424 2423 2424 2423 2424 2423 2424 2423 2424 2413 2414 2479 2479 2479 2479
      2479 2479 2479 2479 2479 2479 2479 2479 2443 2444 2437 2438 2437 2438 2437 2438 2437 2438 2437 2438 2437 2438 2437 2438 2437 2438 2437 2438 2437 2438 2437 2438 2437 2438 2437 2438 2437 2438 2437 2438 2437 2438 2437 2438 2427 2428 2479 2479 2479 2479
      2479 2479 2479 2479 2479 2479 2479 2479 2457 2458 2451 2452 2451 2452 2451 2452 2451 2452 2451 2452 2451 2452 2451 2452 2451 2452 2451 2452 2451 2452 2451 2452 2451 2452 2451 2452 2451 2452 2451 2452 2451 2452 2451 2452 2441 2442 2479 2479 2479 2479
      )
    )
    (tilemap
      (z-pos 100)
      (solid #f)
      (name "Foreground")
      (width 50)
      (height 35)
      (tiles
      0 0 0 0 0 0 0 0 0 0 0 0 0 0 0 0 0 0 0 0 0 0 0 0 0 0 0 0 0 0 0 0 0 0 0 0 0 0 0 0 0 0 0 0 0 0 0 0 0 0
      0 0 0 0 0 0 0 0 0 0 0 0 0 0 0 0 0 0 0 0 0 0 0 0 0 0 0 0 0 0 0 0 0 0 0 0 0 0 0 0 0 0 0 0 0 0 0 0 0 0
      0 0 0 0 0 0 0 0 0 0 0 0 0 0 0 0 0 0 0 0 0 0 0 0 0 0 0 0 0 0 0 0 0 0 0 0 0 0 0 0 0 0 0 0 0 0 0 0 0 0
      0 0 0 0 0 0 0 0 0 0 0 0 0 0 0 0 0 0 0 0 0 0 0 0 0 0 0 0 0 0 0 0 0 0 0 0 0 0 0 0 0 0 0 0 0 0 0 0 0 0
      0 0 0 0 0 0 0 0 0 0 0 0 0 0 0 0 0 0 0 0 0 0 0 0 0 0 0 0 0 0 0 0 0 0 0 0 0 0 0 0 0 0 0 0 0 0 0 0 0 0
      0 0 0 0 0 0 0 0 0 0 0 0 0 0 0 0 0 0 0 0 0 0 0 0 0 0 0 0 0 0 0 0 0 0 0 0 0 0 0 0 0 0 0 0 0 0 0 0 0 0
      0 0 0 0 0 0 0 0 0 0 0 0 0 0 0 0 0 0 0 0 0 0 0 0 0 0 0 0 0 0 0 0 0 0 0 0 0 0 0 0 0 0 0 0 0 0 0 0 0 0
      0 0 0 0 0 0 0 0 0 0 0 0 0 0 0 0 0 0 0 0 0 0 0 0 0 0 0 0 0 0 0 0 0 0 0 0 0 0 0 0 0 0 0 0 0 0 0 0 0 0
      0 0 0 0 0 0 0 0 0 0 0 0 0 0 0 0 0 0 0 0 0 0 0 0 0 0 0 0 0 0 0 0 0 0 0 0 0 0 0 0 0 0 0 0 0 0 0 0 0 0
      0 0 0 0 0 0 0 0 0 0 0 0 0 0 0 0 0 0 0 0 0 0 0 0 0 0 0 0 0 0 0 0 0 0 0 0 0 0 0 0 0 0 0 0 0 0 0 0 0 0
      0 0 0 0 0 0 0 0 0 0 0 0 0 0 0 0 0 0 0 0 0 0 0 0 0 0 0 0 0 0 0 0 0 0 0 0 0 0 0 0 0 0 0 0 0 0 0 0 0 0
      0 0 0 0 0 0 0 0 0 0 0 0 0 0 0 0 0 0 0 0 0 0 0 0 0 0 0 0 0 0 0 0 0 0 0 0 0 0 0 0 0 0 0 0 0 0 0 0 0 0
      0 0 0 0 0 0 0 0 0 0 0 0 0 0 0 0 0 0 0 0 0 0 0 0 0 0 0 0 0 0 0 0 0 0 0 0 0 0 0 0 0 0 0 0 0 0 0 0 0 0
      0 0 0 0 0 0 0 0 0 0 0 0 0 0 0 0 0 0 0 0 0 0 0 0 0 0 0 0 0 0 0 0 0 0 0 0 0 0 0 0 0 0 0 0 0 0 0 0 0 0
      0 0 0 0 0 0 0 0 0 0 0 0 0 0 0 0 0 0 0 0 0 0 0 0 0 0 0 0 0 0 0 0 0 0 0 0 0 0 0 0 0 0 0 0 0 0 0 0 0 0
      0 0 0 0 0 0 0 0 0 0 0 0 0 0 0 0 0 0 0 0 0 0 0 0 0 0 0 0 0 0 0 0 0 0 0 0 0 0 0 0 0 0 0 0 0 0 0 0 0 0
      0 0 0 0 0 0 0 0 0 0 0 0 0 0 0 0 0 0 0 0 0 0 0 0 0 0 0 0 0 0 0 0 0 0 0 0 0 0 0 0 0 0 0 0 0 0 0 0 0 0
      0 0 0 0 0 0 0 0 0 0 0 0 0 0 0 0 0 0 0 0 0 0 0 0 0 0 0 0 0 0 0 0 0 0 0 0 0 0 0 0 0 0 0 0 0 0 0 0 0 0
      0 0 0 0 0 0 0 0 0 0 0 0 0 0 0 0 0 0 0 0 0 0 0 0 0 0 0 0 0 0 0 0 0 0 0 0 0 0 0 0 0 0 0 0 0 0 0 0 0 0
      0 0 0 0 0 0 0 0 0 0 0 0 0 0 0 0 0 0 0 0 0 0 0 0 0 0 0 0 0 0 0 0 0 0 0 0 0 0 0 0 0 0 0 0 0 0 0 0 0 0
      0 0 0 0 0 0 0 0 0 0 0 0 0 0 0 0 0 0 0 0 0 0 0 0 0 0 0 0 0 0 0 0 0 0 0 0 0 0 0 0 0 0 0 0 0 0 0 0 0 0
      0 0 0 0 0 0 0 0 0 0 0 0 0 0 0 0 0 0 0 0 0 0 0 0 0 0 0 0 0 0 0 0 0 0 0 0 0 0 0 0 0 0 0 0 0 0 0 0 0 0
      0 0 0 0 0 0 0 0 0 0 0 0 0 0 0 0 0 0 0 0 0 0 0 0 0 0 0 0 0 0 0 0 0 0 0 0 0 0 0 0 0 0 0 0 0 0 0 0 0 0
      0 0 0 0 0 0 0 0 0 0 0 0 0 0 0 0 0 0 0 0 0 0 0 0 0 0 0 0 0 0 0 0 0 0 0 0 0 0 0 0 0 0 0 0 0 0 0 0 0 0
      0 0 0 0 0 0 0 0 0 0 0 0 0 0 0 0 0 0 0 0 0 0 0 0 0 0 0 0 0 0 0 0 0 0 0 0 0 0 0 0 0 0 0 0 0 0 0 0 0 0
      0 0 0 0 0 0 0 0 0 0 0 0 0 0 0 0 0 0 0 0 0 0 0 0 0 0 0 0 0 0 0 0 0 0 0 0 0 0 0 0 0 0 0 0 0 0 0 0 0 0
      0 0 0 0 0 0 0 0 0 0 0 0 0 0 0 0 0 0 0 0 0 0 0 0 0 0 0 0 0 0 0 0 0 0 0 0 0 0 0 0 0 0 0 0 0 0 0 0 0 0
      0 0 0 0 0 0 0 0 0 0 0 0 0 0 0 0 0 0 0 0 0 0 0 0 0 0 0 0 0 0 0 0 0 0 0 0 0 0 0 0 0 0 0 0 0 0 0 0 0 0
      0 0 0 0 0 0 0 0 0 0 0 0 0 0 0 0 0 0 0 0 0 0 0 0 0 0 0 0 0 0 0 0 0 0 0 0 0 0 0 0 0 0 0 0 0 0 0 0 0 0
      0 0 0 0 0 0 0 0 0 0 0 0 0 0 0 0 0 0 0 0 0 0 0 0 0 0 0 0 0 0 0 0 0 0 0 0 0 0 0 0 0 0 0 0 0 0 0 0 0 0
      0 0 0 0 0 0 0 0 0 0 0 0 0 0 0 0 0 0 0 0 0 0 0 0 0 0 0 0 0 0 0 0 0 0 0 0 0 0 0 0 0 0 0 0 0 0 0 0 0 0
      0 0 0 0 0 0 0 0 0 0 0 0 0 0 0 0 0 0 0 0 0 0 0 0 0 0 0 0 0 0 0 0 0 0 0 0 0 0 0 0 0 0 0 0 0 0 0 0 0 0
      0 0 0 0 0 0 0 0 0 0 0 0 0 0 0 0 0 0 0 0 0 0 0 0 0 0 0 0 0 0 0 0 0 0 0 0 0 0 0 0 0 0 0 0 0 0 0 0 0 0
      0 0 0 0 0 0 0 0 0 0 0 0 0 0 0 0 0 0 0 0 0 0 0 0 0 0 0 0 0 0 0 0 0 0 0 0 0 0 0 0 0 0 0 0 0 0 0 0 0 0
      0 0 0 0 0 0 0 0 0 0 0 0 0 0 0 0 0 0 0 0 0 0 0 0 0 0 0 0 0 0 0 0 0 0 0 0 0 0 0 0 0 0 0 0 0 0 0 0 0 0
      )
    )
  )
)
