(supertux-level
  (version 2)
  (name (_ "Deadly darts"))
  (author "Hume")
  (sector
    (name "main")
    (music "music/bossattack.ogg")
    (init-script "import(\"levels/hume_rainbow_cave/defualt.nut\")
wait(60)
finish_level_group(\"yellow\",\"y6\")")
    (ambient-light 1 1 1)
    (camera
      (mode "normal")
    )
    (darttrap
      (initial-delay 2)
      (fire-delay 1)
      (ammo -1)
      (direction "right")
      (x 192)
      (y 640)
    )
    (darttrap
      (initial-delay 2)
      (fire-delay 4)
      (ammo -1)
      (direction "right")
      (x 192)
      (y 576)
    )
    (darttrap
      (initial-delay 2)
      (fire-delay 16)
      (ammo -1)
      (direction "right")
      (x 192)
      (y 512)
    )
    (darttrap
      (initial-delay 0)
      (fire-delay 8)
      (ammo -1)
      (x 939)
      (y 574)
    )
    (darttrap
      (initial-delay 0)
      (fire-delay 2)
      (ammo -1)
      (x 940)
      (y 641)
    )
    (gradient
      (top_color 1 1 0)
      (bottom_color 1 1 0)
    )
    (spawnpoint
      (name "main")
      (x 832)
      (y 640)
    )
    (tilemap
      (z-pos -100)
      (solid #f)
      (name "Background")
      (width 35)
      (height 25)
      (tiles
      2647 2648 2649 2650 2647 2648 2649 2650 2647 2648 2649 2650 2647 2648 2649 2650 2647 2648 2649 2650 2647 2648 2649 2650 2647 2648 2649 2650 2647 2648 2649 2650 2647 2648 2649
      2651 2652 2653 2654 2651 2652 2653 2654 2651 2652 2653 2654 2651 2652 2653 2654 2651 2652 2653 2654 2651 2652 2653 2654 2651 2652 2653 2654 2651 2652 2653 2654 2651 2652 2653
      2647 2648 2649 2650 2647 2648 2649 2650 2647 2648 2649 2650 2647 2648 2649 2650 2647 2648 2649 2650 2647 2648 2649 2650 2647 2648 2649 2650 2647 2648 2649 2650 2647 2648 2649
      2651 2652 2653 2654 2651 2652 2653 2654 2651 2652 2653 2654 2651 2652 2653 2654 2651 2652 2653 2654 2651 2652 2653 2654 2651 2652 2653 2654 2651 2652 2653 2654 2651 2652 2653
      2647 2648 2649 2650 2647 2648 2649 2650 2647 2648 2649 2650 2647 2648 2649 2650 2647 2648 2649 2650 2647 2648 2649 2650 2647 2648 2649 2650 2647 2648 2649 2650 2647 2648 2649
      2651 2652 2653 2654 2651 2652 2653 2654 2651 2652 2653 2654 2651 2652 2653 2654 2651 2652 2653 2654 2651 2652 2653 2654 2651 2652 2653 2654 2651 2652 2653 2654 2651 2652 2653
      2647 2648 2649 2650 2647 2648 2649 2650 2647 2648 2649 2650 2647 2648 2649 2650 2647 2648 2649 2650 2647 2648 2649 2650 2647 2648 2649 2650 2647 2648 2649 2650 2647 2648 2649
      2651 2652 2653 2654 2651 2652 2653 2654 2651 2652 2653 2654 2651 2652 2653 2654 2651 2652 2653 2654 2651 2652 2653 2654 2651 2652 2653 2654 2651 2652 2653 2654 2651 2652 2653
      2647 2648 2649 2650 2647 2648 2649 2650 2647 2648 2649 2650 2647 2648 2649 2650 2647 2648 2649 2650 2647 2648 2649 2650 2647 2648 2649 2650 2647 2648 2649 2650 2647 2648 2649
      2651 2652 2653 2654 2651 2652 2653 2654 2651 2652 2653 2654 2651 2652 2653 2654 2651 2652 2653 2654 2651 2652 2653 2654 2651 2652 2653 2654 2651 2652 2653 2654 2651 2652 2653
      2647 2648 2649 2650 2647 2648 2649 2650 2647 2648 2649 2650 2647 2648 2649 2650 2647 2648 2649 2650 2647 2648 2649 2650 2647 2648 2649 2650 2647 2648 2649 2650 2647 2648 2649
      2651 2652 2653 2654 2651 2652 2653 2654 2651 2652 2653 2654 2651 2652 2653 2654 2651 2652 2653 2654 2651 2652 2653 2654 2651 2652 2653 2654 2651 2652 2653 2654 2651 2652 2653
      2647 2648 2649 2650 2647 2648 2649 2650 2647 2648 2649 2650 2647 2648 2649 2650 2647 2648 2649 2650 2647 2648 2649 2650 2647 2648 2649 2650 2647 2648 2649 2650 2647 2648 2649
      2651 2652 2653 2654 2651 2652 2653 2654 2651 2652 2653 2654 2651 2652 2653 2654 2651 2652 2653 2654 2651 2652 2653 2654 2651 2652 2653 2654 2651 2652 2653 2654 2651 2652 2653
      2647 2648 2649 2650 2647 2648 2649 2650 2647 2648 2649 2650 2647 2648 2649 2650 2647 2648 2649 2650 2647 2648 2649 2650 2647 2648 2649 2650 2647 2648 2649 2650 2647 2648 2649
      2651 2652 2653 2654 2651 2652 2653 2654 2651 2652 2653 2654 2651 2652 2653 2654 2651 2652 2653 2654 2651 2652 2653 2654 2651 2652 2653 2654 2651 2652 2653 2654 2651 2652 2653
      2647 2648 2649 2650 2647 2648 2649 2650 2647 2648 2649 2650 2647 2648 2649 2650 2647 2648 2649 2650 2647 2648 2649 2650 2647 2648 2649 2650 2647 2648 2649 2650 2647 2648 2649
      2651 2652 2653 2654 2651 2652 2653 2654 2651 2652 2653 2654 2651 2652 2653 2654 2651 2652 2653 2654 2651 2652 2653 2654 2651 2652 2653 2654 2651 2652 2653 2654 2651 2652 2653
      2647 2648 2649 2650 2647 2648 2649 2650 2647 2648 2649 2650 2647 2648 2649 2650 2647 2648 2649 2650 2647 2648 2649 2650 2647 2648 2649 2650 2647 2648 2649 2650 2647 2648 2649
      2651 2652 2653 2654 2651 2652 2653 2654 2651 2652 2653 2654 2651 2652 2653 2654 2651 2652 2653 2654 2651 2652 2653 2654 2651 2652 2653 2654 2651 2652 2653 2654 2651 2652 2653
      2647 2648 2649 2650 2647 2648 2649 2650 2647 2648 2649 2650 2647 2648 2649 2650 2647 2648 2649 2650 2647 2648 2649 2650 2647 2648 2649 2650 2647 2648 2649 2650 2647 2648 2649
      2651 2652 2653 2654 2651 2652 2653 2654 2651 2652 2653 2654 2651 2652 2653 2654 2651 2652 2653 2654 2651 2652 2653 2654 2651 2652 2653 2654 2651 2652 2653 2654 2651 2652 2653
      2647 2648 2649 2650 2647 2648 2649 2650 2647 2648 2649 2650 2647 2648 2649 2650 2647 2648 2649 2650 2647 2648 2649 2650 2647 2648 2649 2650 2647 2648 2649 2650 2647 2648 2649
      2651 2652 2653 2654 2651 2652 2653 2654 2651 2652 2653 2654 2651 2652 2653 2654 2651 2652 2653 2654 2651 2652 2653 2654 2651 2652 2653 2654 2651 2652 2653 2654 2651 2652 2653
      2647 2648 2649 2650 2647 2648 2649 2650 2647 2648 2649 2650 2647 2648 2649 2650 2647 2648 2649 2650 2647 2648 2649 2650 2647 2648 2649 2650 2647 2648 2649 2650 2647 2648 2649
      )
    )
    (tilemap
      (z-pos 0)
      (solid #t)
      (name "Interactive")
      (width 35)
      (height 25)
      (tiles
      2479 2479 2479 2479 2479 2479 2479 2479 2479 2479 2479 2479 2479 2479 2479 2479 2479 2479 2479 2479 2479 2479 2479 2479 2479 2479 2479 2479 2479 2479 2479 2479 2479 2479 2479
      2479 2479 2479 2479 2479 2479 2479 2479 2479 2479 2479 2479 2479 2479 2479 2479 2479 2479 2479 2479 2479 2479 2479 2479 2479 2479 2479 2479 2479 2479 2479 2479 2479 2479 2479
      2479 2479 2479 2479 2479 2479 2479 2479 2479 2479 2479 2479 2479 2479 2479 2479 2479 2479 2479 2479 2479 2479 2479 2479 2479 2479 2479 2479 2479 2479 2479 2479 2479 2479 2479
      2479 2479 2479 2479 2479 2479 2479 2479 2479 2479 2479 2479 2479 2479 2479 2479 2479 2479 2479 2479 2479 2479 2479 2479 2479 2479 2479 2479 2479 2479 2479 2479 2479 2479 2479
      2479 2479 2479 2479 2479 2479 2479 2479 2479 2479 2479 2479 2479 2479 2479 2479 2479 2479 2479 2479 2479 2479 2479 2479 2479 2479 2479 2479 2479 2479 2479 2479 2479 2479 2479
      2479 2479 2479 2479 2471 2472 2507 2508 2507 2508 2507 2508 2507 2508 2507 2508 2507 2508 2507 2508 2507 2508 2507 2508 2507 2508 2507 2508 2507 2508 2469 2470 2479 2479 2479
      2479 2479 2479 2479 2485 2486 0 0 0 0 0 0 0 0 0 0 0 0 0 0 0 0 0 0 0 0 0 0 0 0 2483 2484 2479 2479 2479
      2479 2479 2479 2479 2499 2500 0 0 0 0 0 0 0 0 0 0 0 0 0 0 0 0 0 0 0 0 0 0 0 0 2497 2498 2479 2479 2479
      2479 2479 2479 2479 2513 2514 0 0 0 0 0 0 0 0 0 0 0 0 0 0 0 0 0 0 0 0 0 0 0 0 2511 2512 2479 2479 2479
      2479 2479 2479 2479 2481 2482 0 0 0 0 0 0 0 0 0 0 0 0 0 0 0 0 0 0 0 0 0 0 0 0 2463 2464 2479 2479 2479
      2479 2479 2479 2479 2495 2496 0 0 0 0 0 0 0 0 0 0 0 0 0 0 0 0 0 0 0 0 0 0 0 0 2477 2478 2479 2479 2479
      2479 2479 2479 2479 2467 2468 0 0 0 0 0 0 0 0 0 0 0 0 0 0 0 0 0 0 0 0 0 0 0 0 2491 2492 2479 2479 2479
      2479 2479 2479 2479 2481 2482 0 0 0 0 0 0 0 0 0 0 0 0 0 0 0 0 0 0 0 0 0 0 0 0 2463 2464 2479 2479 2479
      2479 2479 2479 2479 2495 2496 0 0 0 0 0 0 0 0 0 0 0 0 0 0 0 0 0 0 0 0 0 0 0 0 2477 2478 2479 2479 2479
      2479 2479 2479 2479 2467 2468 0 0 0 0 0 0 0 0 0 0 0 0 0 0 0 0 0 0 0 0 0 0 0 0 2491 2492 2479 2479 2479
      2479 2479 2479 2479 2481 2482 0 0 0 0 0 0 0 0 0 0 0 0 0 0 0 0 0 0 0 0 0 0 0 0 2463 2464 2479 2479 2479
      2479 2479 2479 2479 2495 2496 0 0 0 0 0 0 0 0 0 0 0 0 0 0 0 0 0 0 0 0 0 0 0 0 2477 2478 2479 2479 2479
      2479 2479 2479 2479 2467 2468 0 0 0 0 0 0 0 0 0 0 0 0 0 0 0 0 0 0 0 0 0 0 0 0 2491 2492 2479 2479 2479
      2479 2479 2479 2479 2481 2482 0 0 0 0 0 0 0 0 0 0 0 0 0 0 0 0 0 0 0 0 0 0 0 0 2463 2464 2479 2479 2479
      2479 2479 2479 2479 2495 2496 0 0 0 0 0 0 0 0 0 0 0 0 0 0 0 0 0 0 0 0 0 0 0 0 2477 2478 2479 2479 2479
      2479 2479 2479 2479 2415 2416 0 0 0 0 0 0 0 0 0 0 0 0 0 0 0 0 0 0 0 0 0 0 0 0 2491 2492 2479 2479 2479
      2479 2479 2479 2479 2429 2430 2423 2424 2423 2424 2423 2424 2423 2424 2423 2424 2423 2424 2423 2424 2423 2424 2423 2424 2423 2424 2423 2424 2423 2424 2413 2414 2479 2479 2479
      2479 2479 2479 2479 2443 2444 2437 2438 2437 2438 2437 2438 2437 2438 2437 2438 2437 2438 2437 2438 2437 2438 2437 2438 2437 2438 2437 2438 2437 2438 2427 2428 2479 2479 2479
      2479 2479 2479 2479 2457 2458 2451 2452 2451 2452 2451 2452 2451 2452 2451 2452 2451 2452 2451 2452 2451 2452 2451 2452 2451 2452 2451 2452 2451 2452 2441 2442 2479 2479 2479
      2479 2479 2479 2479 2479 2479 2479 2479 2479 2479 2479 2479 2479 2479 2479 2479 2479 2479 2479 2479 2479 2479 2479 2479 2479 2479 2479 2479 2479 2479 2479 2479 2479 2479 2479
      )
    )
    (tilemap
      (z-pos 100)
      (solid #f)
      (name "Foreground")
      (width 35)
      (height 25)
      (tiles
      0 0 0 0 0 0 0 0 0 0 0 0 0 0 0 0 0 0 0 0 0 0 0 0 0 0 0 0 0 0 0 0 0 0 0
      0 0 0 0 0 0 0 0 0 0 0 0 0 0 0 0 0 0 0 0 0 0 0 0 0 0 0 0 0 0 0 0 0 0 0
      0 0 0 0 0 0 0 0 0 0 0 0 0 0 0 0 0 0 0 0 0 0 0 0 0 0 0 0 0 0 0 0 0 0 0
      0 0 0 0 0 0 0 0 0 0 0 0 0 0 0 0 0 0 0 0 0 0 0 0 0 0 0 0 0 0 0 0 0 0 0
      0 0 0 0 0 0 0 0 0 0 0 0 0 0 0 0 0 0 0 0 0 0 0 0 0 0 0 0 0 0 0 0 0 0 0
      0 0 0 0 0 0 0 0 0 0 0 0 0 0 0 0 0 0 0 0 0 0 0 0 0 0 0 0 0 0 0 0 0 0 0
      0 0 0 0 0 0 0 0 0 0 0 0 0 0 0 0 0 0 0 0 0 0 0 0 0 0 0 0 0 0 0 0 0 0 0
      0 0 0 0 0 0 0 0 0 0 0 0 0 0 0 0 0 0 0 0 0 0 0 0 0 0 0 0 0 0 0 0 0 0 0
      0 0 0 0 0 0 0 0 0 0 0 0 0 0 0 0 0 0 0 0 0 0 0 0 0 0 0 0 0 0 0 0 0 0 0
      0 0 0 0 0 0 0 0 0 0 0 0 0 0 0 0 0 0 0 0 0 0 0 0 0 0 0 0 0 0 0 0 0 0 0
      0 0 0 0 0 0 0 0 0 0 0 0 0 0 0 0 0 0 0 0 0 0 0 0 0 0 0 0 0 0 0 0 0 0 0
      0 0 0 0 0 0 0 0 0 0 0 0 0 0 0 0 0 0 0 0 0 0 0 0 0 0 0 0 0 0 0 0 0 0 0
      0 0 0 0 0 0 0 0 0 0 0 0 0 0 0 0 0 0 0 0 0 0 0 0 0 0 0 0 0 0 0 0 0 0 0
      0 0 0 0 0 0 0 0 0 0 0 0 0 0 0 0 0 0 0 0 0 0 0 0 0 0 0 0 0 0 0 0 0 0 0
      0 0 0 0 0 0 0 0 0 0 0 0 0 0 0 0 0 0 0 0 0 0 0 0 0 0 0 0 0 0 0 0 0 0 0
      0 0 0 0 0 0 0 0 0 0 0 0 0 0 0 0 0 0 0 0 0 0 0 0 0 0 0 0 0 0 0 0 0 0 0
      0 0 0 0 0 0 0 0 0 0 0 0 0 0 0 0 0 0 0 0 0 0 0 0 0 0 0 0 0 0 0 0 0 0 0
      0 0 0 0 0 0 0 0 0 0 0 0 0 0 0 0 0 0 0 0 0 0 0 0 0 0 0 0 0 0 0 0 0 0 0
      0 0 0 0 0 0 0 0 0 0 0 0 0 0 0 0 0 0 0 0 0 0 0 0 0 0 0 0 0 0 0 0 0 0 0
      0 0 0 0 0 0 0 0 0 0 0 0 0 0 0 0 0 0 0 0 0 0 0 0 0 0 0 0 0 0 0 0 0 0 0
      0 0 0 0 0 0 0 0 0 0 0 0 0 0 0 0 0 0 0 0 0 0 0 0 0 0 0 0 0 0 0 0 0 0 0
      0 0 0 0 0 0 0 0 0 0 0 0 0 0 0 0 0 0 0 0 0 0 0 0 0 0 0 0 0 0 0 0 0 0 0
      0 0 0 0 0 0 0 0 0 0 0 0 0 0 0 0 0 0 0 0 0 0 0 0 0 0 0 0 0 0 0 0 0 0 0
      0 0 0 0 0 0 0 0 0 0 0 0 0 0 0 0 0 0 0 0 0 0 0 0 0 0 0 0 0 0 0 0 0 0 0
      0 0 0 0 0 0 0 0 0 0 0 0 0 0 0 0 0 0 0 0 0 0 0 0 0 0 0 0 0 0 0 0 0 0 0
      )
    )
  )
)
