(supertux-level
  (version 2)
  (name (_ "octo's Island"))
  (author "Florian Forster")
  (contact "octo at verplant.org")
  (license "GPL 2+ / CC-by-sa 3.0")
  (sector
    (name "main")
    (ambient-light 1 1 1)
    (tilemap
      (solid #t)
      (z-pos 0)
      (name "Interactive")
      (width 40)
      (height 20)
      (tiles
      9 9 9 11 16 16 16 16 16 12 9 9 9 9 9 9 9 9 9 9 9 9 9 9 9 9 9 9 9 9 9 9 9 9 9 9 9 9 9 9
      9 9 9 15 24 25 25 26 19 17 9 9 9 9 9 9 9 9 9 9 9 9 9 9 9 9 9 9 9 9 9 9 9 9 9 9 9 9 9 9
      9 9 9 15 31 32 32 34 26 17 9 9 9 9 9 9 9 9 9 9 11 16 16 16 16 16 16 16 16 12 9 9 9 9 9 9 9 9 9 9
      9 9 9 15 31 35 36 32 27 17 9 9 9 9 9 9 9 9 9 9 15 49 50 51 19 19 19 19 19 17 9 9 9 9 9 9 9 9 9 9
      9 9 9 15 31 27 30 36 27 17 9 9 9 9 9 9 9 9 9 11 22 52 53 54 19 48 40 40 39 17 9 9 9 9 9 9 9 9 9 9
      9 9 9 15 30 28 19 30 28 17 9 9 9 9 11 16 16 16 16 22 19 55 56 57 40 42 19 19 47 17 9 9 9 9 9 9 9 9 9 9
      9 9 9 15 69 66 66 66 66 73 74 74 74 74 75 43 40 40 40 40 39 19 24 25 25 25 26 48 42 17 9 9 9 9 9 9 9 9 9 9
      9 9 9 14 18 18 18 18 18 13 9 9 9 9 15 65 20 18 18 21 65 19 30 29 29 29 28 47 20 13 9 9 9 9 9 9 9 9 9 9
      9 9 9 9 9 9 9 9 9 9 9 9 9 9 15 65 17 9 9 15 37 40 40 43 40 40 40 42 17 9 9 9 9 9 9 9 9 9 9 9
      9 9 9 9 9 9 9 9 9 9 9 9 9 9 15 65 17 9 9 14 21 19 19 68 19 19 19 20 13 9 9 9 9 9 9 9 9 9 9 9
      9 11 16 16 16 16 16 12 9 9 9 9 9 9 15 65 17 9 9 9 14 18 18 18 18 18 18 13 9 9 9 9 9 9 9 9 9 9 9 9
      11 22 48 40 40 40 39 23 16 16 16 16 16 16 22 65 23 16 16 16 16 16 16 16 16 16 16 16 12 9 9 9 9 9 9 9 9 9 9 9
      15 19 65 19 19 19 37 40 40 40 40 40 40 40 40 45 40 40 40 40 40 40 43 40 40 40 40 39 23 12 9 9 9 9 9 9 9 9 9 9
      15 19 37 40 39 19 19 19 20 18 18 18 18 18 21 65 20 18 18 18 18 21 37 40 39 19 19 65 19 23 12 9 9 9 9 9 9 9 9 9
      14 18 21 19 47 19 60 19 17 9 9 9 9 9 15 65 17 9 9 9 9 15 19 19 65 19 19 65 19 19 17 9 9 9 9 9 9 9 9 9
      9 9 14 21 37 40 40 71 17 9 9 9 9 11 22 65 23 16 12 9 9 14 18 21 37 39 19 37 40 71 17 9 9 9 9 9 9 9 9 9
      9 9 9 14 18 18 18 18 13 9 9 9 9 15 19 65 19 58 23 12 9 9 9 14 21 68 19 19 19 19 17 9 9 9 9 9 9 9 9 9
      9 9 9 9 9 9 9 9 9 9 9 9 9 15 19 65 19 59 19 17 9 9 9 9 14 18 18 18 18 18 13 9 9 9 9 9 9 9 9 9
      9 9 9 9 9 9 9 9 9 9 9 9 9 15 19 37 40 42 20 13 9 9 9 9 9 9 9 9 9 9 9 9 9 9 9 9 9 9 9 9
      9 9 9 9 9 9 9 9 9 9 9 9 9 14 18 18 18 18 13 9 9 9 9 9 9 9 9 9 9 9 9 9 9 9 9 9 9 9 9 9
      )
    )
    (level
      (name "drawbridge.stl")
      (x 20)
      (y 7)
    )
    (level
      (name "entrance.stl")
      (x 23)
      (y 9)
    )
    (level
      (name "throne_room.stl")
      (x 28)
      (y 4)
    )
    (level
      (name "tower.stl")
      (x 22)
      (y 5)
    )
    (level
      (name "torture_chamber.stl")
      (x 25)
      (y 5)
    )
    (level
      (name "broken_escalator.stl")
      (x 17)
      (y 6)
    )
    (level
      (name "yoshi2.stl")
      (x 12)
      (y 12)
    )
    (level
      (name "chocolate2.stl")
      (x 7)
      (y 15)
    )
    (level
      (name "SML0102.stl")
      (x 6)
      (y 6)
    )
    (level
      (name "SML0101.stl")
      (x 8)
      (y 6)
    )
    (level
      (name "SML0103.stl")
      (x 4)
      (y 6)
    )
    (level
      (name "get_em_all.stl")
      (x 29)
      (y 15)
    )
    (level
      (name "through_mountain.stl")
      (x 25)
      (y 16)
    )
    (level
      (name "cube_garden.stl")
      (x 22)
      (y 12)
    )
    (level
      (name "cherry_frosting.stl")
      (x 18)
      (y 12)
    )
    (level
      (name "jolly_jumper.stl")
      (x 26)
      (y 12)
    )
    (worldmap-spawnpoint
      (name "main")
      (x 17)
      (y 17)
    )
  )
  (tileset "images/worldmap.strf")
)
