(supertux-level
  (version 2)
  (name (_ "There's Snow Bonus like a Snow Bonus!"))
  (author "Lolkat")
  (license "GPL 2+ / CC-by-sa 3.0")
  (sector
    (name "main")
    (music "music/theme.ogg")
    (ambient-light 1 1 1)
    (background
      (speed 0.5)
      (image-top "images/background/arctis_bottom.jpg")
      (image "images/background/arctis_bottom.jpg")
      (image-bottom "images/background/arctis_bottom.jpg")
    )
    (camera
      (mode "normal")
    )
    (spawnpoint
      (name "main")
      (x 96)
      (y 96)
    )
    (tilemap
      (solid #f)
      (z-pos -100)
      (name "Background")
      (width 20)
      (height 20)
      (tiles
      0 0 0 0 0 0 0 0 0 0 0 0 0 0 0 0 0 0 0 0
      0 0 0 0 0 0 0 0 0 0 0 0 0 0 0 0 0 0 0 0
      0 0 0 0 0 0 0 0 0 0 0 0 0 0 0 0 0 0 0 0
      0 0 0 0 0 0 0 0 0 0 0 0 0 0 0 0 0 0 0 0
      0 0 0 0 0 0 0 0 0 0 0 0 0 0 0 0 0 0 0 0
      0 0 0 0 0 0 0 0 0 0 0 0 0 0 0 0 0 0 0 0
      0 0 0 0 0 0 0 0 0 0 0 0 0 0 0 0 0 0 0 0
      0 0 0 0 0 0 0 0 0 0 0 0 0 0 0 0 0 0 0 0
      0 0 0 0 0 0 0 0 0 0 0 0 0 0 0 0 0 0 0 0
      0 0 0 0 0 0 0 0 0 0 0 0 0 0 0 0 0 0 0 0
      0 0 0 0 0 0 0 0 0 0 0 0 0 0 0 0 0 0 0 0
      0 0 0 0 0 0 0 0 0 0 0 0 0 0 0 0 0 0 0 0
      0 0 0 0 0 0 0 0 0 0 0 0 0 0 0 0 0 0 0 0
      0 0 0 0 0 0 0 0 0 0 0 0 0 0 0 0 0 0 0 0
      0 0 0 0 0 0 0 0 0 0 0 0 0 0 0 0 0 0 0 0
      0 0 0 0 0 0 0 0 0 0 0 0 0 0 0 0 0 0 0 0
      0 0 0 0 0 0 0 0 0 0 0 0 0 0 0 0 0 0 0 0
      0 0 0 0 0 0 0 0 0 0 0 0 0 0 0 0 0 0 0 0
      0 0 0 0 0 0 0 0 0 0 0 0 0 0 0 0 0 0 0 0
      0 0 0 0 0 0 0 0 0 0 0 0 0 0 0 0 0 0 0 0
      )
    )
    (tilemap
      (solid #t)
      (z-pos 0)
      (name "Interactive")
      (width 20)
      (height 20)
      (tiles
      0 0 0 0 0 0 0 0 0 0 0 0 0 0 0 0 0 0 0 0
      44 44 44 44 44 44 44 0 0 0 0 0 0 0 0 0 0 0 0 0
      44 44 83 83 83 44 44 0 0 0 0 0 0 0 0 0 0 0 0 0
      44 83 44 0 44 83 44 0 0 0 0 0 0 0 0 0 0 0 0 0
      44 44 44 44 44 44 44 0 0 0 0 0 0 0 0 0 0 0 0 0
      44 44 44 44 44 44 44 0 0 0 0 0 0 0 0 128 140 140 128 0
      44 44 44 44 44 44 44 0 0 0 0 0 0 0 0 0 0 0 0 0
      44 83 44 44 44 83 44 0 0 0 0 0 0 0 0 0 0 0 0 0
      44 44 44 44 44 44 44 0 0 0 0 0 0 0 7 8 8 8 8 9
      44 44 44 44 44 44 44 0 0 0 0 0 0 0 13 14 14 14 14 15
      44 44 44 44 44 44 44 0 0 0 7 8 9 0 10 11 11 11 11 12
      44 102 44 44 44 102 44 0 0 0 13 14 15 0 48 48 48 48 48 48
      44 44 44 44 44 44 44 0 0 0 10 11 12 0 0 129 133 132 132 48
      44 44 44 44 44 44 44 7 8 9 16 17 18 0 0 129 133 132 132 48
      44 44 44 44 44 44 44 13 14 15 0 0 0 0 0 129 133 132 132 48
      44 102 44 44 44 102 44 10 11 12 0 0 0 0 0 129 133 132 132 48
      44 44 44 44 44 44 44 16 17 18 0 0 0 0 0 129 133 132 132 48
      7 8 8 8 8 8 8 8 8 8 8 8 8 9 0 129 133 132 132 48
      13 14 14 14 14 14 14 14 14 14 14 14 14 15 48 48 48 48 48 48
      10 11 11 11 11 11 11 11 11 11 11 11 11 12 0 0 0 0 0 0
      )
    )
    (tilemap
      (solid #f)
      (z-pos 100)
      (name "Foreground")
      (width 20)
      (height 20)
      (tiles
      0 0 0 0 0 0 0 0 0 0 0 0 0 0 0 0 0 0 0 0
      0 0 0 0 0 0 0 0 0 0 0 0 0 0 0 0 0 0 0 0
      0 0 0 0 0 0 0 0 0 0 0 0 0 0 0 0 0 0 0 0
      0 0 0 0 0 0 0 0 0 0 0 0 0 0 0 0 0 0 0 0
      0 0 0 0 0 0 0 0 0 0 0 0 0 0 0 0 0 0 0 0
      0 0 0 0 0 0 0 0 0 0 0 0 0 0 0 0 0 0 0 0
      0 0 0 0 0 0 0 0 0 0 0 0 0 0 0 0 0 0 0 0
      0 0 0 0 0 0 0 0 0 0 0 0 0 0 0 0 0 0 0 0
      0 0 0 0 0 0 0 0 0 0 0 0 0 0 0 0 0 0 0 0
      0 0 0 0 0 0 0 0 0 0 0 0 0 0 0 0 0 0 0 0
      0 0 0 0 0 0 0 0 0 0 0 0 0 0 0 0 0 0 0 0
      0 0 0 0 0 0 0 0 0 0 0 0 0 0 0 0 0 0 0 0
      0 0 0 0 0 0 0 0 0 0 0 0 0 0 0 0 0 0 0 0
      0 0 0 0 0 0 0 0 0 0 0 0 0 0 0 0 0 0 0 0
      0 0 0 0 0 0 0 0 0 0 0 0 0 0 0 0 0 0 0 0
      0 0 0 0 0 0 0 0 0 0 0 0 0 0 0 0 0 0 0 0
      0 0 0 0 0 0 0 0 0 0 0 0 0 0 0 0 0 0 0 0
      0 0 0 0 0 0 0 0 0 0 0 0 0 0 0 0 0 0 0 0
      0 0 0 0 0 0 0 0 0 0 0 0 0 0 0 0 0 0 0 0
      0 0 0 0 0 0 0 0 0 0 0 0 0 0 0 0 0 0 0 0
      )
    )
  )
)
