(supertux-level
  (version 2)
  (name (_ "Bonus Level: Skellington Arena"))
  (author "LMH")
  (license  "GPL 2 / CC-by-sa 3.0"  )
  (sector
    (name  "main"  )
    (music  "music/chipdisko.ogg"  )
    (ambient-light  1  1  1  )
    (camera
      (mode  "normal"  ))
    (background
      (image  "images/background/semi_arctic.jpg"  )
      (speed  0.5  ))
    (init-script "  gate <- true;
      cage <- true;
      hidden <- true;
      discover(\"Arena\");  ")
    (spawnpoint
      (name  "main"  )
      (x  0  )
      (y   256  ))
    (scripttrigger
      (script "if(gate){  gate <- false;
        dropL1.goto_node(1);
        dropL2.goto_node(1);
        dropL3.goto_node(1);
        dropL4.goto_node(1);
        dropR1.goto_node(1);
        dropR2.goto_node(1);
        dropR3.goto_node(1);
        dropR4.goto_node(1);
        dropL1.goto_node(2);
        dropL2.goto_node(2);
        dropL3.goto_node(2);
        dropL4.goto_node(2);
        dropR1.goto_node(2);
        dropR2.goto_node(2);
        dropR3.goto_node(2);
        dropR4.goto_node(2);  }")
      (button  #f  )
      (x  256  )(y  256  )(width  320  )(height  96  ))
    (scripttrigger
      (script "
        cageA.goto_node(1);
        wait(  3  );
        cageB1.goto_node(1);
        cageB2.goto_node(1);
        wait(  3  );
        cageC1.goto_node(1);
        cageC2.goto_node(1);
        cageC3.goto_node(1);
        wait(  3  );
        holdtop.goto_node(1);
        holdmid.goto_node(1);
        holdbot.goto_node(1);  ")
      (button  #f  )
      (x  224  )(y  1024  )(width  384  )(height  32  ))
    (scripttrigger  (script "  if(hidden){hidden <- false; find(\"ahole\");}  ")(button  #f  )
      (width   32  )(height  32  )
      (x  1168  )(y  208  ))
    (tilemap
      (z-pos  0  )
      (solid  #t  )
      (speed  1  )
      (width   40  )
      (height   36  )
      (tiles
0  0  0  0  0  0  0  0  0  0  0  0  0  0  0  0  0  0  0  0  0  0  0  10  11  11  11  11  11  11  11  11  11  11  11  11  11  11  11  11
0  0  0  0  0  0  0  0  0  0  0  0  0  0  0  0  0  0  0  0  0  0  0  10  11  11  11  11  11  11  11  11  11  11  11  11  11  11  11  11
0  0  0  0  0  0  0  0  0  0  0  0  0  0  0  0  0  0  0  0  0  0  0  0  0  0  0  0  0  0  0  0  0  11  11  30  17  17  31  11
0  0  0  0  0  0  0  0  0  0  0  0  0  0  0  0  0  0  0  0  0  0  0  0  0  0  0  0  0  0  0  0  0  11  11  12  0  0  10  11
0  0  0  0  0  0  0  0  0  0  0  0  0  0  0  0  0  0  0  0  0  0  0  0  0  0  0  0  0  0  0  0  0  11  11  12  0  0  10  11
122  123  0  0  0  0  0  0  0  0  0  0  0  0  0  0  0  0  0  0  0  0  0  10  11  11  11  11  11  11  11  0  0  0  0  18  104  105  10  11
124  125  0  0  0  0  0  0  0  0  0  0  0  0  0  0  0  0  0  0  0  0  0  10  11  11  11  11  11  11  11  0  0  0  0  0  0  0  10  11
124  125  0  0  0  0  0  0  0  0  0  0  0  0  0  0  0  0  0  0  0  0  0  10  11  11  11  11  11  11  11  0  0  0  0  8  8  8  22  11
124  125  0  0  0  0  0  0  0  0  0  0  0  0  0  0  0  0  0  0  0  0  0  10  11  11  11  11  11  11  11  11  11  11  11  14  14  14  23  11
8  8  8  8  8  8  8  9  0  0  0  0  0  0  0  0  0  0  7  8  8  8  8  22  11  11  11  11  11  11  11  11  11  11  11  11  11  11  11  11
14  14  14  14  14  14  14  15  0  0  0  0  0  0  0  0  0  0  13  14  14  14  14  23  11  11  11  11  11  11  11  11  11  11  11  11  11  11  11  11
11  11  11  11  11  11  11  12  47  0  0  0  0  0  0  0  0  47  10  11  11  11  11  11  11  11  11  11  11  11  11  11  11  11  11  11  11  11  11  11
11  11  11  11  11  11  11  12  0  0  0  0  0  0  0  0  0  0  10  11  11  11  11  11  11  11  11  11  11  11  11  11  11  11  11  11  11  11  11  11
11  11  11  11  11  11  11  12  0  0  0  0  0  0  0  0  0  0  10  11  11  11  11  11  11  11  11  11  11  11  11  11  11  11  11  11  11  11  11  11
11  11  11  11  11  11  11  12  0  0  0  0  0  0  0  0  0  0  10  11  11  11  11  11  11  11  11  11  11  11  11  11  11  11  11  11  11  11  11  11
11  11  11  11  11  11  11  12  0  0  0  0  0  0  0  0  0  0  10  11  11  11  11  11  11  11  11  11  11  11  11  11  11  11  11  11  11  11  11  11
11  11  11  11  11  11  11  12  0  0  0  0  0  0  0  0  0  0  10  11  11  11  11  11  11  11  11  11  11  11  11  11  11  11  11  11  11  11  11  11
11  11  11  11  11  11  11  12  0  0  0  0  0  0  0  0  0  0  10  11  11  11  11  11  11  11  11  11  11  11  11  11  11  11  11  11  11  11  11  11
11  11  11  11  11  11  11  12  0  0  0  0  0  0  0  0  0  0  10  11  11  11  11  11  11  11  11  11  11  11  11  11  11  11  11  11  11  11  11  11
11  30  17  17  17  17  17  18  0  0  0  0  0  0  0  0  0  0  16  17  17  17  17  17  17  129  17  17  17  17  17  31  11  11  11  11  11  11  11  11
11  12  0  0  0  0  0  0  0  0  0  0  0  0  0  0  0  0  0  0  0  0  0  0  0  0  133  0  0  0  0  16  17  31  11  11  11  11  11  11
11  12  0  0  0  0  0  0  0  0  0  0  0  0  0  0  0  0  0  0  0  0  0  0  0  0  133  0  0  0  0  0  0  10  11  11  11  11  11  11
11  21  8  8  8  9  0  0  0  0  0  0  0  0  0  0  0  0  0  0  0  0  0  0  0  0  133  0  0  0  0  0  0  16  17  31  11  11  11  11
11  20  14  14  14  15  0  0  0  0  0  0  0  0  0  0  0  0  0  0  27  28  28  28  28  28  28  28  28  29  0  0  0  0  0  10  11  11  11  11
11  30  17  17  17  18  0  0  0  0  0  0  0  0  0  0  0  0  0  0  0  0  0  0  0  0  133  0  0  0  0  0  0  0  0  16  17  31  11  11
11  12  0  0  0  0  0  0  0  0  0  0  0  0  0  0  0  0  0  0  0  0  0  0  0  0  133  0  0  0  0  0  0  0  0  0  0  16  17  17
11  12  0  0  0  0  0  0  0  0  0  0  0  0  0  0  0  0  0  0  0  0  0  0  0  0  133  0  0  0  0  0  0  0  0  0  0  0  0  132
11  21  8  8  8  8  9  0  0  0  0  0  0  0  0  0  0  0  0  0  0  0  0  0  0  0  133  0  0  0  0  0  0  0  0  0  0  0  0  132
11  20  14  14  14  14  15  0  0  0  0  0  0  0  0  0  0  0  0  27  28  28  28  28  28  28  28  28  28  28  29  0  0  0  0  0  0  0  0  132
11  30  17  17  17  17  18  0  0  0  0  0  0  0  0  0  0  0  0  0  0  0  0  0  0  0  133  0  0  0  0  0  0  0  0  0  0  0  0  132
11  12  0  0  0  0  0  0  0  0  0  0  0  0  0  0  0  0  0  0  0  0  0  0  0  0  133  0  0  0  0  0  0  0  0  0  0  0  0  132
11  12  0  0  0  0  0  0  0  0  0  0  0  0  0  0  0  0  0  0  0  0  0  0  0  0  133  0  0  0  0  0  0  0  0  0  0  0  0  132
11  21  8  8  8  8  8  8  8  8  8  8  8  8  8  8  8  8  8  8  8  8  8  8  9  0  133  7  8  8  8  8  8  8  8  8  8  8  8  8
11  20  14  14  14  14  14  14  14  14  14  14  14  14  14  14  14  14  14  14  14  14  14  14  15  27  29  13  14  14  14  14  14  14  14  14  14  14  14  14
11  11  11  11  11  11  11  11  11  11  11  11  11  11  11  11  11  11  11  11  11  11  11  11  12  0  0  10  11  11  11  11  11  11  11  11  11  11  11  11
11  11  11  11  11  11  11  11  11  11  11  11  11  11  11  11  11  11  11  11  11  11  11  11  12  0  0  10  11  11  11  11  11  11  11  11  11  11  11  11
    )  )
    (tilemap
      (z-pos  100  )
      (solid  #f  )
      (speed  1  )
      (width   40  )
      (height   36  )
      (tiles
0  0  0  0  0  0  0  0  0  0  0  0  0  0  0  0  0  0  0  0  0  0  0  10  11  11  11  11  11  11  11  11  11  11  11  11  11  11  11  11
0  0  0  0  0  0  0  0  0  0  0  0  0  0  0  0  0  0  0  0  0  0  0  10  11  11  11  11  11  11  11  11  11  11  11  11  11  11  11  11
0  0  0  0  0  0  0  0  0  0  0  0  0  0  0  0  0  0  0  0  0  0  0  10  11  11  11  11  11  11  11  11  11  11  11  30  17  17  31  11
0  0  0  0  0  0  0  0  0  0  0  0  0  0  0  0  0  0  0  0  0  0  0  10  11  11  11  11  11  11  11  11  11  11  11  12  0  0  10  11
0  0  0  0  0  0  0  0  0  0  0  0  0  0  0  0  0  0  0  0  0  0  0  10  11  11  11  11  11  11  11  11  11  11  11  12  0  0  10  11
0  0  0  0  0  0  0  0  0  0  0  0  0  0  0  0  0  0  0  0  0  0  0  10  11  11  11  11  11  11  11  11  11  11  11  12  0  0  10  11
0  0  0  0  0  0  0  0  0  0  0  0  0  0  0  0  0  0  0  0  0  0  0  10  11  11  11  11  11  11  11  11  11  11  11  12  0  0  10  11
0  0  0  0  0  0  0  0  0  0  0  0  0  0  0  0  0  0  0  0  0  0  0  10  11  11  11  11  11  11  11  11  11  11  11  21  8  8  22  11
0  0  0  0  0  0  0  0  0  0  0  0  0  0  0  0  0  0  0  0  0  0  0  10  11  11  11  11  11  11  11  11  11  11  11  20  14  14  23  11
0  0  0  0  0  0  0  0  0  0  0  0  0  0  0  0  0  0  0  0  0  0  0  0  0  0  0  0  0  0  0  0  0  0  0  0  0  0  0  0
0  0  0  0  0  0  0  0  0  0  0  0  0  0  0  0  0  0  0  0  0  0  0  0  0  0  0  0  0  0  0  0  0  0  0  0  0  0  0  0
0  0  0  0  0  0  0  0  0  0  0  0  0  0  0  0  0  0  0  0  0  0  0  0  0  0  0  0  0  0  0  0  0  0  0  0  0  0  0  0
11  11  11  11  11  11  11  12  0  0  0  0  0  0  0  0  0  0  10  11  11  11  11  11  11  11  0  0  0  0  0  0  0  0  0  0  0  0  0  0
11  11  11  11  11  11  11  12  0  0  0  0  0  0  0  0  0  0  10  11  11  11  11  11  11  11  0  0  0  0  0  0  0  0  0  0  0  0  0  0
11  11  11  11  11  11  11  12  0  0  0  0  0  0  0  0  0  0  10  11  11  11  11  11  11  11  0  0  0  0  0  0  0  0  0  0  0  0  0  0
11  11  11  11  11  11  11  12  0  0  0  0  0  0  0  0  0  0  10  11  11  11  11  11  11  11  0  0  0  0  0  0  0  0  0  0  0  0  0  0
11  11  11  11  11  11  11  12  0  0  0  0  0  0  0  0  0  0  10  11  11  11  11  11  11  11  0  0  0  0  0  0  0  0  0  0  0  0  0  0
11  11  11  11  11  11  11  12  0  0  0  0  0  0  0  0  0  0  10  11  11  11  11  11  11  11  0  0  0  0  0  0  0  0  0  0  0  0  0  0
11  11  11  11  11  11  11  12  0  0  0  0  0  0  0  0  0  0  10  11  11  11  11  11  11  11  0  0  0  0  0  0  0  0  0  0  0  0  0  0
11  30  17  17  17  17  17  18  0  0  0  0  0  0  0  0  0  0  16  17  17  17  17  17  17  17  0  0  0  0  0  0  0  0  0  0  0  0  0  0
0  0  0  0  0  0  0  0  0  0  0  0  0  0  0  0  0  0  0  0  0  0  0  0  0  129  0  0  0  0  0  0  0  0  0  0  0  0  0  0
0  0  0  0  0  0  0  0  0  0  0  0  0  0  0  0  0  0  0  0  0  0  0  0  0  129  0  0  0  0  0  0  0  0  0  0  0  0  0  0
0  0  0  0  0  0  0  0  0  0  0  0  0  0  0  0  0  0  0  0  0  0  0  0  0  129  0  0  0  0  0  0  0  0  0  0  0  0  0  0
0  0  14  14  14  15  0  0  0  0  0  0  0  0  0  0  0  0  0  0  27  28  28  28  28  28  0  0  0  0  0  0  0  0  0  0  0  0  0  0
0  0  17  17  17  18  0  0  0  0  0  0  0  0  0  0  0  0  0  0  0  0  0  0  0  129  0  0  0  0  0  0  0  0  0  0  0  0  0  0
0  0  0  0  0  0  0  0  0  0  0  0  0  0  0  0  0  0  0  0  0  0  0  0  0  129  0  0  0  0  0  0  0  0  0  0  0  0  0  0
0  0  0  0  0  0  0  0  0  0  0  0  0  0  0  0  0  0  0  0  0  0  0  0  0  129  0  0  0  0  0  0  0  0  0  0  0  0  0  0
0  0  0  0  0  0  0  0  0  0  0  0  0  0  0  0  0  0  0  0  0  0  0  0  0  129  0  0  0  0  0  0  0  0  0  0  0  0  0  0
0  0  14  14  14  14  15  0  0  0  0  0  0  0  0  0  0  0  0  27  28  28  28  28  28  28  0  0  0  0  0  0  0  0  0  0  0  0  0  0
0  0  17  17  17  17  18  0  0  0  0  0  0  0  0  0  0  0  0  0  0  0  0  0  0  129  0  0  0  0  0  0  0  0  0  0  0  0  0  0
0  0  0  0  0  0  0  0  0  0  0  0  0  0  0  0  0  0  0  0  0  0  0  0  0  129  0  0  0  0  0  0  0  0  0  0  0  0  0  0
0  0  0  0  0  0  0  0  0  0  0  0  0  0  0  0  0  0  0  0  0  0  0  0  0  129  0  0  0  0  0  0  0  0  0  0  0  0  0  0
0  0  0  0  0  0  0  0  0  0  0  0  0  0  0  0  0  0  0  0  0  0  0  0  0  129  0  0  0  0  0  0  0  0  0  0  0  0  0  0
0  0  14  14  14  14  14  14  14  14  14  14  14  14  14  14  14  14  14  14  14  14  14  14  15  0  0  0  0  0  0  0  0  0  0  0  0  0  0  0
0  0  11  11  11  11  11  11  11  11  11  11  11  11  11  11  11  11  11  11  11  11  11  11  12  0  0  0  0  0  0  0  0  0  0  0  0  0  0  0
0  0  11  11  11  11  11  11  11  11  11  11  11  11  11  11  11  11  11  11  11  11  11  11  12  0  0  0  0  0  0  0  0  0  0  0  0  0  0  0
    )  )
    (tilemap
      (z-pos  -100  )
      (solid  #f  )
      (speed  1  )
      (width   40  )
      (height   36  )
      (tiles
0  0  0  0  0  0  0  0  0  0  0  0  0  0  0  0  0  0  0  0  0  0  0  0  0  0  0  0  0  0  0  0  0  0  0  0  0  0  0  0
0  0  0  0  0  0  0  0  0  0  0  0  0  0  0  0  0  0  0  0  0  0  0  0  0  0  0  0  0  0  0  0  0  0  0  0  0  0  0  0
0  0  0  0  0  0  0  0  0  0  0  0  0  0  0  0  0  0  0  0  0  0  0  0  0  0  0  0  0  0  0  0  0  0  0  0  0  0  0  0
0  0  0  0  0  0  0  0  0  0  0  0  0  0  0  0  0  0  0  0  0  0  0  0  0  0  0  0  0  0  0  0  0  0  0  0  0  0  0  0
0  0  0  0  0  0  0  0  0  0  0  0  0  0  0  0  0  0  0  0  0  0  0  0  0  0  0  0  0  0  0  0  0  0  0  0  0  0  0  0
122  123  0  0  0  0  0  0  0  0  0  0  0  0  0  0  0  0  0  0  0  0  0  0  0  0  0  0  0  0  0  0  0  0  0  0  0  0  0  0
124  125  0  0  0  0  0  0  0  0  0  0  0  0  0  0  0  0  0  0  0  0  0  0  0  0  0  0  0  0  0  0  0  0  0  0  0  0  0  0
124  125  0  0  0  0  0  0  0  0  0  0  0  0  0  0  0  0  0  0  0  0  0  0  0  0  0  0  0  0  0  0  0  0  0  0  0  0  0  0
124  125  0  122  123  0  0  0  0  0  0  0  0  0  0  0  0  0  0  0  0  0  0  0  0  0  0  0  0  0  0  0  0  0  0  0  0  0  0  0
124  125  0  124  125  0  0  0  0  0  0  0  0  0  0  0  0  0  0  0  0  0  0  0  0  0  0  0  0  0  0  0  0  0  0  0  0  0  0  0
32  32  32  32  32  32  32  32  32  32  32  32  32  32  32  32  32  32  32  32  32  32  32  32  32  32  32  32  32  32  32  32  32  32  32  32  32  32  32  32
36  36  36  36  36  36  36  36  36  36  36  36  36  36  36  36  36  36  36  36  36  36  36  36  36  36  36  36  36  36  36  36  36  36  36  36  36  36  36  36
36  36  36  36  36  36  36  36  36  36  36  36  36  36  36  36  36  36  36  36  36  36  36  36  36  36  36  36  36  36  36  36  36  36  36  36  36  36  36  36
36  36  36  36  36  36  36  36  36  36  36  36  36  36  36  36  36  36  36  36  36  36  36  36  36  36  36  36  36  36  36  36  36  36  36  36  36  36  36  36
36  36  36  36  36  36  36  36  36  36  36  36  36  36  36  36  36  36  36  36  36  36  36  36  36  36  36  36  36  36  36  36  36  36  36  36  36  36  36  36
36  36  36  36  36  36  36  36  36  36  36  36  36  36  36  36  36  36  36  36  36  36  36  36  36  36  36  36  36  36  36  36  36  36  36  36  36  36  36  36
36  36  36  36  36  36  36  36  36  36  36  36  36  36  36  36  36  36  36  36  36  36  36  36  36  36  36  36  36  36  36  36  36  36  36  36  36  36  36  36
36  36  36  36  36  36  36  36  36  36  36  36  36  36  36  36  36  36  36  36  36  36  36  36  36  36  36  36  36  36  36  36  36  36  36  36  36  36  36  36
36  36  36  36  36  36  36  36  36  36  36  36  36  36  36  36  36  36  36  36  36  36  36  36  36  36  36  36  36  36  36  36  36  36  36  36  36  36  36  36
36  36  36  36  36  36  36  36  36  36  36  36  36  36  36  36  36  36  36  36  36  36  36  36  36  36  36  36  36  36  36  36  36  36  36  36  36  36  36  36
36  36  36  36  36  36  36  36  36  36  36  36  36  36  36  36  36  36  36  36  36  36  36  36  36  36  36  36  36  36  36  36  36  36  36  36  36  36  36  36
36  36  36  36  36  36  36  36  36  36  36  36  36  36  36  36  36  36  36  36  36  36  36  36  36  36  36  36  36  36  36  36  36  36  36  36  36  36  36  36
36  36  36  36  36  36  36  36  36  36  36  36  36  36  36  36  36  36  36  36  36  36  36  36  36  36  36  36  36  36  36  36  36  36  36  36  36  36  36  36
36  36  36  36  36  36  36  36  36  36  36  36  36  36  36  36  36  36  36  36  36  36  36  36  36  36  36  36  36  36  36  36  36  36  36  36  36  36  36  36
36  36  36  36  36  36  36  36  36  36  36  36  36  36  36  36  36  36  36  36  36  36  36  36  36  36  36  36  36  36  36  36  36  36  36  36  36  36  36  36
36  36  36  36  36  36  36  36  36  36  36  36  36  36  36  36  36  36  36  36  36  36  36  36  36  36  36  36  36  36  36  36  36  36  36  36  36  36  36  36
36  36  36  36  36  36  36  36  36  36  36  36  36  36  36  36  36  36  36  36  36  36  36  36  36  36  36  36  36  36  36  36  36  36  36  36  36  36  36  36
36  36  36  36  36  36  36  36  36  36  36  36  36  36  36  36  36  36  36  36  36  36  36  36  36  36  36  36  36  36  36  36  36  36  36  36  36  36  36  36
36  36  36  36  36  36  36  36  36  36  36  36  36  36  36  36  36  36  36  36  36  36  36  36  36  36  36  36  36  36  36  36  36  36  36  36  36  36  36  36
36  36  36  36  36  36  36  36  36  36  36  36  36  36  36  36  36  36  36  36  36  36  36  36  36  36  36  36  36  36  36  36  36  36  36  36  36  36  36  36
36  36  36  36  36  36  36  36  36  36  36  36  36  36  36  36  36  36  36  36  36  36  36  36  36  36  36  36  36  36  36  36  36  36  36  36  36  36  36  36
36  36  36  36  36  36  36  36  36  36  36  36  36  36  36  36  36  36  36  36  36  36  36  36  36  36  36  36  36  36  36  36  36  36  36  36  36  36  36  36
36  36  36  36  36  36  36  36  36  36  36  36  36  36  36  36  36  36  36  36  36  36  36  36  36  36  36  36  36  36  36  36  36  36  36  36  36  36  36  36
36  36  36  36  36  36  36  36  36  36  36  36  36  36  36  36  36  36  36  36  36  36  36  36  36  36  36  36  36  36  36  36  36  36  36  36  36  36  36  36
36  36  36  36  36  36  36  36  36  36  36  36  36  36  36  36  36  36  36  36  36  36  36  36  36  36  36  36  36  36  36  36  36  36  36  36  36  36  36  36
36  36  36  36  36  36  36  36  36  36  36  36  36  36  36  36  36  36  36  36  36  36  36  36  36  36  36  36  36  36  36  36  36  36  36  36  36  36  36  36
    )  )
    (platform
      (name  "dropL1"  )
      (running  #f  )
      (sprite  "images/objects/platforms/wood-tiny.sprite"  )
      (path  (node  (x  288  )  (y  352  )  (time  0.5  ))
        (node  (x  288  )  (y  384  )  (time  3  ))
        (node  (x  256  )  (y  384  )  (time  2  ))
    )  )
    (platform
      (name  "dropL2"  )
      (running  #f  )
      (sprite  "images/objects/platforms/wood-tiny.sprite"  )
      (path  (node  (x  320  )  (y  352  )  (time  0.5  ))
        (node  (x  320  )  (y  416  )  (time  3  ))
        (node  (x  256  )  (y  416  )  (time  2  ))
    )  )
    (platform
      (name  "dropL3"  )
      (running  #f  )
      (sprite  "images/objects/platforms/wood-tiny.sprite"  )
      (path  (node  (x  352  )  (y  352  )  (time  0.5  ))
        (node  (x  352  )  (y  448  )  (time  3  ))
        (node  (x  256  )  (y  448  )  (time  2  ))
    )  )
    (platform
      (name  "dropL4"  )
      (running  #f  )
      (sprite  "images/objects/platforms/wood-tiny.sprite"  )
      (path  (node  (x  384  )  (y  352  )  (time  0.5  ))
        (node  (x  384  )  (y  480  )  (time  3  ))
        (node  (x  256  )  (y  480  )  (time  2  ))
    )  )
    (platform
      (name  "dropR1"  )
      (running  #f  )
      (sprite  "images/objects/platforms/wood-tiny.sprite"  )
      (path  (node  (x  512  )  (y  352  )  (time  0.5  ))
        (node  (x  512  )  (y  384  )  (time  3  ))
        (node  (x  544  )  (y  384  )  (time  2  ))
    )  )
    (platform
      (name  "dropR2"  )
      (running  #f  )
      (sprite  "images/objects/platforms/wood-tiny.sprite"  )
      (path  (node  (x  480  )  (y  352  )  (time  0.5  ))
        (node  (x  480  )  (y  416  )  (time  3  ))
        (node  (x  544  )  (y  416  )  (time  2  ))
    )  )
    (platform
      (name  "dropR3"  )
      (running  #f  )
      (sprite  "images/objects/platforms/wood-tiny.sprite"  )
      (path  (node  (x  448  )  (y  352  )  (time  0.5  ))
        (node  (x  448  )  (y  448  )  (time  3  ))
        (node  (x  544  )  (y  448  )  (time  2  ))
    )  )
    (platform
      (name  "dropR4"  )
      (running  #f  )
      (sprite  "images/objects/platforms/wood-tiny.sprite"  )
      (path  (node  (x  416  )  (y  352  )  (time  0.5  ))
        (node  (x  416  )  (y  480  )  (time  3  ))
        (node  (x  544  )  (y  480  )  (time  2  ))
    )  )
    (platform
      (name  "holdtop"  )
      (running  #f  )
      (sprite  "images/objects/platforms/vertical-wood.sprite"  )
      (path  (node  (x  768  )  (y  608  )  (time  2  ))
        (node  (x  768  )  (y  480  )  (time  2  ))
    )  )
    (platform
      (name  "holdmid"  )
      (running  #f  )
      (sprite  "images/objects/platforms/vertical-wood.sprite"  )
      (path  (node  (x  768  )  (y  768  )  (time  4  ))
        (node  (x  768  )  (y  1120  )  (time  4  ))
    )  )
    (platform
      (name  "holdbot"  )
      (running  #f  )
      (sprite  "images/objects/platforms/vertical-wood.sprite"  )
      (path  (node  (x  768  )  (y  928  )  (time  2  ))
        (node  (x  768  )  (y  1120  )  (time  2  ))
    )  )
    (platform
      (name  "cageA"  )
      (running  #f  )
      (sprite  "images/objects/platforms/vertical-wood.sprite"  )
      (path  (node  (x  192  )  (y  768  )  (time  4  ))
        (node  (x  192  )  (y  1120  )  (time  4  ))
    )  )
    (platform
      (name  "cageB1"  )
      (running  #f  )
      (sprite  "images/objects/platforms/vertical-wood.sprite"  )
      (path  (node  (x  608  )  (y  768  )  (time  4  ))
        (node  (x  608  )  (y  1120  )  (time  4  ))
    )  )
    (platform
      (name  "cageB2"  )
      (running  #f  )
      (sprite  "images/objects/platforms/vertical-wood.sprite"  )
      (path  (node  (x  192  )  (y  928  )  (time  2  ))
        (node  (x  192  )  (y  1120  )  (time  2  ))
    )  )
    (platform
      (name  "cageC1"  )
      (running  #f  )
      (sprite  "images/objects/platforms/vertical-wood.sprite"  )
      (path  (node  (x  608  )  (y  928  )  (time  2  ))
        (node  (x  608  )  (y  1120  )  (time  2  ))
    )  )
    (platform
      (name  "cageC2"  )
      (running  #f  )
      (sprite  "images/objects/platforms/vertical-wood.sprite"  )
      (path  (node  (x  160  )  (y  608  )  (time  2  ))
        (node  (x  160  )  (y  480  )  (time  2  ))
    )  )
    (platform
      (name  "cageC3"  )
      (running  #f  )
      (sprite  "images/objects/platforms/vertical-wood.sprite"  )
      (path  (node  (x  640  )  (y  608  )  (time  2  ))
        (node  (x  640  )  (y  480  )  (time  2  ))
    )  )
    (powerup  (x  864  )(y  704  )(sprite  "images/powerups/1up/1up.sprite"  ))
    (powerup  (x  864  )(y  864  )(sprite  "images/powerups/iceflower/iceflower.sprite"  )(script "  Tux.add_bonus(\"iceflower\");  Tux.add_bonus(\"iceflower\");  Tux.add_bonus(\"iceflower\");  powerup();  "))
    (powerup  (x  864  )(y  1024  )(sprite  "images/powerups/fireflower/fireflower.sprite"  ))
    (skullyhop  (x  64  )(y  704  ))
    (skullyhop  (x  64  )(y  864  ))
    (skullyhop  (x  64  )(y  1024  ))
    (skullyhop  (x  736  )(y  704  ))
    (skullyhop  (x  736  )(y  864  ))
    (skullyhop  (x  736  )(y  1024  ))
)  )
