(supertux-level																																									
	(version 	2	)																																						
	(name (_ "Den of the Iceborer"))																																								
	(author "LMH")																																								
	(contact "lmh.0013@gmail.com")																																								
	(license	"GPL 2 / CC-by-sa 3.0"	)																																						
																																									
																																									
	(sector																																								
	(name	"main"	)																																						
	(music	 "music/airship_remix.ogg"	)																																						
	(ambient-light	1	1	1	)																																				
	(camera	(mode	"normal"	))																																					
	(gradient	(top_color 	0	0	0	)																																			
		(bottom_color	1	1	1	))																																			
	(init-script "	import(\"levels/mattie_world/doom_islands/Iceborer.nut\");	running <- false;	")																																					
																																									
	(spawnpoint	(name	"main"	)(x	64	)(y	320	))																																	
																																									
	(scripttrigger	(script "	prepare_iceborer();	")(button	#f	)																																			
		(width	4	)(height	384	)																																			
		(x	96	)(y	0	))																																			
	(scripttrigger	(script "	begin_iceborer_battle();	")(button	#f	)																																			
		(width	4	)(height	384	)																																			
		(x	208	)(y	0	))																																			
	(scripttrigger	(script "	hit <- true;	")(button	#f	)																																			
		(width	960	)(height	4	)																																			
		(x	160	)(y	32	))																																			
																																									
	(trampoline	(x	176	)(y	672	)(portable	#f	))																																	
	(trampoline	(x	208	)(y	672	)(portable	#f	))																																	
																																									
	(tilemap	(name	"Interactive"	)(speed	1	)																																			
		(z-pos	0	)(solid	#t	)																																			
		(width	40	)(height	25	)																																			
		(tiles	;	128	160	192	224	256	288	320	352	384	416	448	480	512	544	576	608	640	672	704	736	768	800	832	864	896	928	960	992	1024	1056	1088	1120	1152	1184	1216	1248		
0	0	0	0	0	0	0	0	0	0	0	0	0	0	0	0	0	0	0	0	0	0	0	0	0	0	0	0	0	0	0	0	0	0	0	0	0	0	0	0	;	0
0	0	0	0	0	0	0	0	0	0	0	0	0	0	0	0	0	0	0	0	0	0	0	0	0	0	0	0	0	0	0	0	0	0	0	0	0	0	0	0	;	32
0	0	0	0	0	0	0	0	0	0	0	0	0	0	0	0	0	0	0	0	0	0	0	0	0	0	0	0	0	0	0	0	0	0	0	0	0	0	0	0	;	64
0	0	0	0	0	0	0	0	0	0	0	0	0	0	0	0	0	0	0	0	0	0	0	0	0	0	0	0	0	0	0	0	0	0	0	0	0	0	0	0	;	96
0	0	0	0	0	0	0	0	0	0	0	0	0	0	0	0	0	0	0	0	0	0	0	0	0	0	0	0	0	0	0	0	0	0	0	0	0	0	0	0	;	128
0	0	0	0	0	0	0	0	0	0	0	0	0	0	0	0	0	0	0	0	0	0	0	0	0	0	0	0	0	0	0	0	0	0	0	0	0	0	0	0	;	160
0	0	0	0	0	0	0	0	0	0	0	0	0	0	0	0	0	0	0	0	0	0	0	0	0	0	0	0	0	0	0	0	0	0	0	0	0	0	0	0	;	192
0	0	0	0	0	0	0	0	0	0	0	0	0	0	0	0	0	0	0	0	0	0	0	0	0	0	0	0	0	0	0	0	0	0	0	0	0	0	0	0	;	224
0	0	0	0	0	0	0	0	0	0	0	0	0	0	0	0	0	0	0	0	0	0	0	0	0	0	0	0	0	0	0	0	0	0	0	0	0	0	0	0	;	256
0	0	0	0	0	0	0	0	0	0	0	0	0	0	0	0	0	0	0	0	0	0	0	0	0	0	0	0	0	0	0	0	0	0	0	0	0	0	0	0	;	288
0	0	0	0	0	0	0	0	0	0	0	0	0	0	0	0	0	0	0	0	0	0	0	0	0	0	0	0	0	0	0	0	0	0	0	0	0	0	0	0	;	320
8	8	8	8	9	0	0	0	0	0	0	0	0	0	0	0	0	0	0	0	0	0	0	0	0	0	0	0	0	0	0	0	0	0	0	7	8	8	8	8	;	352
14	14	14	14	15	77	77	77	77	77	77	77	77	77	77	77	77	77	77	77	77	77	77	77	77	77	77	77	77	77	77	77	77	77	77	13	14	14	14	14	;	384
11	11	11	11	12	77	77	77	77	77	77	77	77	77	77	77	77	77	77	77	77	77	77	77	77	77	77	77	77	77	77	77	77	77	77	10	11	11	11	11	;	416
11	11	11	11	12	77	77	77	77	77	77	77	77	77	77	77	77	77	77	77	77	77	77	77	77	77	77	77	77	77	77	77	77	77	77	10	11	11	11	11	;	448
11	11	11	11	12	77	77	77	77	77	77	77	77	77	77	77	77	77	77	77	77	77	77	77	77	77	77	77	77	77	77	77	77	77	77	10	11	11	11	11	;	480
11	11	11	11	12	77	77	77	77	77	77	77	77	77	77	77	77	77	77	77	77	77	77	77	77	77	77	77	77	77	77	77	77	77	77	10	11	11	11	11	;	512
11	11	11	11	12	77	77	77	77	77	77	77	77	77	77	77	77	77	77	77	77	77	77	77	77	77	77	77	77	77	77	77	77	77	77	10	11	11	11	11	;	544
11	11	11	11	12	77	77	77	77	77	77	77	77	77	77	77	77	77	77	77	77	77	77	77	77	77	77	77	77	77	77	77	77	77	77	10	11	11	11	11	;	576
11	11	11	11	12	77	77	77	77	77	77	77	77	77	77	77	77	77	77	77	77	77	77	77	77	77	77	77	77	77	77	77	77	77	77	10	11	11	11	11	;	608
11	11	11	11	12	0	0	0	0	0	0	0	0	0	0	0	0	0	0	0	0	0	0	0	0	0	0	0	0	0	0	0	0	0	0	10	11	11	11	11	;	640
11	11	11	11	12	0	0	0	0	0	0	0	0	0	0	0	0	0	0	0	0	0	0	0	0	0	0	0	0	0	0	0	0	0	0	10	11	11	11	11	;	672
11	11	11	11	12	0	0	0	0	0	0	0	0	0	0	0	0	0	0	0	0	0	0	0	0	0	0	0	0	0	0	0	0	0	0	10	11	11	11	11	;	704
11	11	11	11	12	0	0	0	0	0	0	0	0	0	0	0	0	0	0	0	0	0	0	0	0	0	0	0	0	0	0	0	0	0	0	10	11	11	11	11	;	736
11	11	11	11	12	0	0	0	0	0	0	0	0	0	0	0	0	0	0	0	0	0	0	0	0	0	0	0	0	0	0	0	0	0	0	10	11	11	11	11	;	768
	))																																								
	(tilemap	(name	"deliver"	)																																					
		(z-pos	50	)(solid	#t	)																																			
		(width	4	)(height	2	)																																			
		(path	(node	(x	144	)(y	672	)(time	0.1	))																															
			(node	(x	240	)(y	672	)(time	0.1	))																															
			(node	(x	336	)(y	672	)(time	0.1	))																															
			(node	(x	432	)(y	672	)(time	0.1	))																															
			(node	(x	528	)(y	672	)(time	0.1	))																															
			(node	(x	624	)(y	672	)(time	0.1	))																															
			(node	(x	720	)(y	672	)(time	0.1	))																															
			(node	(x	816	)(y	672	)(time	0.1	))																															
			(node	(x	912	)(y	672	)(time	0.1	))																															
			(node	(x	1008	)(y	672	)(time	0.1	))	)																														
		(tiles	1311	131	131	1311		1311	1311	1311	1311	))																													
																																									
	(tilemap	(name	"bounceNbreak"	)(alpha	0	)																																			
		(z-pos	0	)(solid	#t	)																																			
		(width	4	)(height	4	)																																			
		(path	(node	(x	144	)(y	672	)(time	1	))																															
			(node	(x	144	)(y	288	)(time	2	))																															
			(node	(x	144	)(y	672	)(time	3	))																															
			(node	(x	720	)(y	672	)(time	1	))																															
			(node	(x	720	)(y	304	)(time	2	))																															
			(node	(x	720	)(y	672	)(time	3	))																															
			(node	(x	432	)(y	672	)(time	1	))																															
			(node	(x	432	)(y	288	)(time	2	))																															
			(node	(x	432	)(y	672	)(time	3	))																															
			(node	(x	1008	)(y	672	)(time	1	))																															
			(node	(x	1008	)(y	288	)(time	2	))																															
			(node	(x	1008	)(y	672	)(time	3	))																															
			(node	(x	528	)(y	672	)(time	1	))																															
			(node	(x	528	)(y	288	)(time	2	))																															
			(node	(x	528	)(y	672	)(time	3	))																															
			(node	(x	240	)(y	672	)(time	1	))																															
			(node	(x	240	)(y	256	)(time	2	))																															
			(node	(x	240	)(y	672	)(time	3	))																															
			(node	(x	816	)(y	672	)(time	1	))																															
			(node	(x	816	)(y	288	)(time	2	))																															
			(node	(x	816	)(y	672	)(time	3	))																															
			(node	(x	336	)(y	672	)(time	1	))																															
			(node	(x	336	)(y	288	)(time	2	))																															
			(node	(x	336	)(y	672	)(time	3	))																															
			(node	(x	912	)(y	672	)(time	1	))																															
			(node	(x	912	)(y	256	)(time	2	))																															
			(node	(x	912	)(y	672	)(time	3	))																															
			(node	(x	624	)(y	672	)(time	1	))																															
			(node	(x	624	)(y	288	)(time	2	))																															
			(node	(x	624	)(y	672	)(time	3	))	)																														
		(tiles	2820	0	0	2819		0	48	48	0		2820	0	0	2819		0	48	48	0	))																			
	(tilemap	(name	"pain"	)(alpha	0	)																																			
		(z-pos	-10	)(solid	#t	)																																			
		(width	3	)(height	5	)																																			
		(path	(node	(x	160	)(y	640	)(time	1	))																															
			(node	(x	160	)(y	288	)(time	2	))																															
			(node	(x	160	)(y	640	)(time	3	))																															
			(node	(x	736	)(y	640	)(time	1	))																															
			(node	(x	736	)(y	304	)(time	2	))																															
			(node	(x	736	)(y	640	)(time	3	))																															
			(node	(x	448	)(y	640	)(time	1	))																															
			(node	(x	448	)(y	288	)(time	2	))																															
			(node	(x	448	)(y	640	)(time	3	))																															
			(node	(x	1024	)(y	640	)(time	1	))																															
			(node	(x	1024	)(y	288	)(time	2	))																															
			(node	(x	1024	)(y	640	)(time	3	))																															
			(node	(x	544	)(y	640	)(time	1	))																															
			(node	(x	544	)(y	288	)(time	2	))																															
			(node	(x	544	)(y	640	)(time	3	))																															
			(node	(x	256	)(y	640	)(time	1	))																															
			(node	(x	256	)(y	256	)(time	2	))																															
			(node	(x	256	)(y	640	)(time	3	))																															
			(node	(x	832	)(y	640	)(time	1	))																															
			(node	(x	832	)(y	288	)(time	2	))																															
			(node	(x	832	)(y	640	)(time	3	))																															
			(node	(x	352	)(y	640	)(time	1	))																															
			(node	(x	352	)(y	288	)(time	2	))																															
			(node	(x	352	)(y	640	)(time	3	))																															
			(node	(x	928	)(y	640	)(time	1	))																															
			(node	(x	928	)(y	256	)(time	2	))																															
			(node	(x	928	)(y	640	)(time	3	))																															
			(node	(x	640	)(y	640	)(time	1	))																															
			(node	(x	640	)(y	288	)(time	2	))																															
			(node	(x	640	)(y	640	)(time	3	))	)																														
		(tiles	0	295	0		298	0	296		298	0	296		298	0	296		298	0	296	))																			
	(tilemap	(name	"walls"	)																																					
		(z-pos	-10	)(solid	#t	)																																			
		(path	(node	(x	64	)(y	384	)(time	1	))																															
			(node	(x	64	)(y	-32	)(time	1	))	)																														
		(width	36	)(height	13	)																																			
		(tiles	84	84	84	0	0	0	0	0	0	0	0	0	0	0	0	0	0	0	0	0	0	0	0	0	0	0	0	0	0	0	0	0	0	84	84	84			
			84	84	84	0	0	0	0	0	0	0	0	0	0	0	0	0	0	0	0	0	0	0	0	0	0	0	0	0	0	0	0	0	0	84	84	84			
			84	84	84	0	0	0	0	0	0	0	0	0	0	0	0	0	0	0	0	0	0	0	0	0	0	0	0	0	0	0	0	0	0	84	84	84			
			84	84	84	0	0	0	0	0	0	0	0	0	0	0	0	0	0	0	0	0	0	0	0	0	0	0	0	0	0	0	0	0	0	84	84	84			
			84	84	84	0	0	0	0	0	0	0	0	0	0	0	0	0	0	0	0	0	0	0	0	0	0	0	0	0	0	0	0	0	0	84	84	84			
			84	84	84	0	0	0	0	0	0	0	0	0	0	0	0	0	0	0	0	0	0	0	0	0	0	0	0	0	0	0	0	0	0	84	84	84			
			84	84	84	0	0	0	0	0	0	0	0	0	0	0	0	0	0	0	0	0	0	0	0	0	0	0	0	0	0	0	0	0	0	84	84	84			
			84	84	84	0	0	0	0	0	0	0	0	0	0	0	0	0	0	0	0	0	0	0	0	0	0	0	0	0	0	0	0	0	0	84	84	84			
			84	84	84	0	0	0	0	0	0	0	0	0	0	0	0	0	0	0	0	0	0	0	0	0	0	0	0	0	0	0	0	0	0	84	84	84			
			84	84	84	0	0	0	0	0	0	0	0	0	0	0	0	0	0	0	0	0	0	0	0	0	0	0	0	0	0	0	0	0	0	84	84	84			
			84	84	84	0	0	0	0	0	0	0	0	0	0	0	0	0	0	0	0	0	0	0	0	0	0	0	0	0	0	0	0	0	0	84	84	84			
			84	84	84	0	0	0	0	0	0	0	0	0	0	0	0	0	0	0	0	0	0	0	0	0	0	0	0	0	0	0	0	0	0	84	84	84			
			84	84	84	0	0	0	0	0	0	0	0	0	0	0	0	0	0	0	0	0	0	0	0	0	0	0	0	0	0	0	0	0	0	84	84	84	))		
))																																									
