(supertux-level																																									
	(version 	2	)																																						
	(name (_ "Decrepit Yeti"))																																								
	(author "LMH")																																								
	(contact "lmh.0013@gmail.com")																																								
	(license	"GPL 2 / CC-by-sa 3.0"	)																																						
																																									
																																									
	(sector																																								
	(name	"main"	)																																						
	(music	"music/bossattack.ogg"	)																																						
	(ambient-light	1	1	1	)																																				
	(camera	(mode	"normal"	))																																					
	(gradient	(top_color 	0	0	0	)																																			
		(bottom_color	0.4	0.4	0.4	))																																			
	(init-script "			")																																					
																																									
	(spawnpoint	(name	"main"	)(x	624	)(y	0	))																																	
																																									
	(yeti	(dead-script "sector.Tux.trigger_sequence(\"fireworks\");")																																							
		(x	64	)(y	320	))																																			
																																									
	(yeti_stalactite	(x	48	)(y	224	))																																			
	(yeti_stalactite	(x	80	)(y	224	))																																			
	(yeti_stalactite	(x	112	)(y	224	))																																			
	(yeti_stalactite	(x	144	)(y	224	))																																			
	(yeti_stalactite	(x	176	)(y	224	))																																			
	(yeti_stalactite	(x	208	)(y	224	))																																			
																																									
	(unstable_tile	(x	576	)(y	544	)(sprite "images/objects/unstable_tile/snow.sprite"))																																			
	(unstable_tile	(x	608	)(y	544	)(sprite "images/objects/unstable_tile/snow.sprite"))																																			
	(unstable_tile	(x	640	)(y	544	)(sprite "images/objects/unstable_tile/snow.sprite"))																																			
	(unstable_tile	(x	672	)(y	544	)(sprite "images/objects/unstable_tile/snow.sprite"))																																			
																																									
	(yeti_stalactite	(x	1040	)(y	224	))																																			
	(yeti_stalactite	(x	1072	)(y	224	))																																			
	(yeti_stalactite	(x	1104	)(y	224	))																																			
	(yeti_stalactite	(x	1136	)(y	224	))																																			
	(yeti_stalactite	(x	1168	)(y	224	))																																			
	(yeti_stalactite	(x	1200	)(y	224	))																																			
																																									
	(dispenser	(cycle	7	)(badguy	"bouncingsnowball"	)(type	"cannon"	)																																	
		(x	352	)(y	96	)(direction	"right"	))																																	
	(dispenser	(cycle	6.5	)(badguy	"bouncingsnowball"	)(type	"cannon"	)																																	
		(x	1216	)(y	96	)(direction	"left"	))																																	
																																									
	(rock	(x	777	)(y	32	))																																			
	(rock	(x	902	)(y	33	))																																			
	(rock	(x	939	)(y	34	))																																			
																																									
	(tilemap	(name	"Interactive"	)(speed	1	)																																			
		(z-pos	0	)(solid	#t	)																																			
		(width	40	)(height	25	)																																			
		(tiles	;	128	160	192	224	256	288	320	352	384	416	448	480	512	544	576	608	640	672	704	736	768	800	832	864	896	928	960	992	1024	1056	1088	1120	1152	1184	1216	1248		
0	0	0	0	0	0	0	0	0	0	0	0	0	0	0	0	0	0	0	0	0	0	0	0	0	0	0	0	0	0	0	0	0	0	0	0	0	0	0	0	;	0
8	8	8	8	8	8	8	8	8	8	8	8	8	8	8	8	9	0	0	0	0	0	0	7	8	8	8	8	8	8	8	8	8	8	8	8	8	8	8	8	;	32
14	14	14	14	14	14	14	14	14	14	14	14	14	14	14	14	15	0	0	0	0	0	0	13	14	14	14	14	14	14	14	14	14	14	14	14	14	14	14	14	;	64
11	11	11	11	11	11	11	11	11	11	30	2820	7	8	8	8	9	0	0	0	0	0	0	7	8	8	8	8	8	8	8	8	8	8	8	8	8	9	2819	31	;	96
11	11	11	11	11	11	11	11	11	11	21	8	114	14	14	14	15	0	0	0	0	0	0	13	14	14	14	14	14	14	14	14	14	14	14	14	14	113	8	22	;	128
11	11	11	11	11	11	11	11	11	11	20	14	23	11	11	11	12	0	0	0	0	0	0	10	11	11	11	11	11	11	11	11	11	11	11	11	11	20	14	23	;	160
11	11	11	11	11	11	11	11	11	11	11	11	11	11	11	11	12	0	0	0	0	0	0	10	11	11	11	11	11	11	11	11	11	11	11	11	11	11	11	11	;	192
30	17	17	17	17	17	17	17	31	11	11	11	11	11	11	11	12	0	0	0	0	0	0	10	11	11	11	11	11	11	11	30	17	17	17	17	17	17	17	31	;	224
12	0	0	0	0	0	0	0	16	17	31	11	11	11	11	11	12	0	0	0	0	0	0	10	11	11	11	11	11	30	17	18	0	0	0	0	0	0	0	10	;	256
12	0	0	0	0	0	0	0	0	0	16	17	17	31	11	11	12	0	0	0	0	0	0	10	11	11	30	17	17	18	0	0	0	0	0	0	0	0	0	10	;	288
12	0	0	0	0	0	0	0	0	0	0	0	0	16	17	17	18	0	0	0	0	0	0	16	17	17	18	0	0	0	0	0	0	0	0	0	0	0	0	10	;	320
12	0	0	0	0	0	0	0	0	0	0	0	0	0	0	0	0	0	0	0	0	0	0	0	0	0	0	0	0	0	0	0	0	0	0	0	0	0	0	10	;	352
12	0	0	0	0	0	0	0	0	0	0	0	0	0	0	0	0	0	0	0	0	0	0	0	0	0	0	0	0	0	0	0	0	0	0	0	0	0	0	10	;	384
21	8	8	8	8	9	0	0	0	0	0	0	0	0	0	0	0	0	0	0	0	0	0	0	0	0	0	0	0	0	0	0	0	0	7	8	8	8	8	22	;	416
20	14	14	14	14	15	0	0	0	0	0	0	0	0	0	0	0	0	0	0	0	0	0	0	0	0	0	0	0	0	0	0	0	0	13	14	14	14	14	23	;	448
11	11	11	11	11	12	0	0	0	0	0	0	0	0	0	0	0	0	0	0	0	0	0	0	0	0	0	0	0	0	0	0	0	0	10	11	11	11	11	11	;	480
11	11	11	11	11	12	0	0	0	0	0	0	0	0	0	0	0	0	0	0	0	0	0	0	0	0	0	0	0	0	0	0	0	0	10	11	11	11	11	11	;	512
11	11	11	11	11	12	0	0	0	0	0	0	0	0	0	0	0	0	0	0	0	0	0	0	0	0	0	0	0	0	0	0	0	0	10	11	11	11	11	11	;	544
11	11	11	11	11	12	0	0	0	0	0	0	0	0	0	0	0	0	0	0	0	0	0	0	0	0	0	0	0	0	0	0	0	0	10	11	11	11	11	11	;	576
11	11	11	11	11	12	0	0	0	0	0	0	0	0	0	0	0	0	0	0	0	0	0	0	0	0	0	0	0	0	0	0	0	0	10	11	11	11	11	11	;	608
11	11	11	11	11	12	0	0	0	0	0	7	8	8	8	8	8	8	8	8	8	8	8	8	8	8	8	8	9	0	0	0	0	0	10	11	11	11	11	11	;	640
11	11	11	11	11	12	0	0	0	0	0	13	14	14	14	14	14	14	14	14	14	14	14	14	14	14	14	14	15	0	0	0	0	0	10	11	11	11	11	11	;	672
11	11	11	11	11	21	8	8	8	8	8	22	11	11	11	11	11	11	11	11	11	11	11	11	11	11	11	11	21	8	8	8	8	8	22	11	11	11	11	11	;	704
11	11	11	11	11	20	14	14	14	14	14	23	11	11	11	11	11	11	11	11	11	11	11	11	11	11	11	11	20	14	14	14	14	14	23	11	11	11	11	11	;	736
11	11	11	11	11	11	11	11	11	11	11	11	11	11	11	11	11	11	11	11	11	11	11	11	11	11	11	11	11	11	11	11	11	11	11	11	11	11	11	11	;	768
))																																									
	(tilemap	(name	"Background"	)(speed	1	)																																			
		(z-pos	-100	)(solid	#t	)																																			
		(width	40	)(height	25	)																																			
		(tiles																																							
1795	1795	1795	1796	1795	1797	1797	1795	1795	1796	1796	1795	1797	1795	1795	1795	1798	0	0	0	0	0	0	0	0	0	0	0	0	0	0	0	0	0	0	0	0	0	0	0		
1795	1797	1795	1796	1796	1796	1797	1796	1795	1795	1797	1795	1795	1796	1795	1797	1798	0	0	0	0	0	0	0	0	0	0	0	0	0	0	0	0	0	0	0	0	0	0	0		
0	0	0	0	0	0	0	0	0	0	0	0	0	0	0	0	0	0	0	0	0	0	0	0	0	0	0	0	0	0	0	0	0	0	0	0	0	0	0	0		
0	0	0	0	0	0	0	0	0	0	0	17	17	17	17	17	18	0	0	0	0	0	0	16	17	17	17	17	17	17	17	17	17	17	17	17	17	17	17	0		
0	0	0	0	0	0	0	0	0	0	0	0	0	0	0	0	0	0	0	0	0	0	0	0	0	0	0	0	0	0	0	0	0	0	0	0	0	0	0	0		
0	0	0	0	0	0	0	0	0	0	0	0	0	0	0	0	0	0	0	0	0	0	0	0	0	0	0	0	0	0	0	0	0	0	0	0	0	0	0	0		
0	0	0	0	0	0	0	0	0	0	0	0	0	0	0	0	0	0	0	0	0	0	0	0	0	0	0	0	0	0	0	0	0	0	0	0	0	0	0	0		
0	0	0	0	0	0	0	0	0	0	0	0	0	0	0	0	0	0	0	0	0	0	0	0	0	0	0	0	0	0	0	0	0	0	0	0	0	0	0	0		
0	0	0	0	0	0	0	0	0	0	0	0	0	0	0	0	0	0	0	0	0	0	0	0	0	0	0	0	0	0	0	0	0	0	0	0	0	0	0	0		
0	0	0	0	0	0	0	0	0	0	0	0	0	0	0	0	0	0	0	0	0	0	0	0	0	0	0	0	0	0	0	0	0	0	0	0	0	0	0	0		
0	0	0	0	0	0	0	0	0	0	0	0	0	0	0	0	0	0	0	0	0	0	0	0	0	0	0	0	0	0	0	0	0	0	0	0	0	0	0	0		
0	0	0	0	0	0	0	0	0	0	0	0	0	0	0	0	0	0	0	0	0	0	0	0	0	0	0	0	0	0	0	0	0	0	0	0	0	0	0	0		
0	0	0	0	0	0	0	0	0	0	0	0	0	0	0	0	0	0	2052	2053	2053	2054	0	0	0	0	0	0	0	0	0	0	0	0	0	0	0	0	0	0		
0	0	0	0	0	0	0	0	0	0	0	0	0	0	0	0	0	2052	2056	2070	2071	2055	2054	0	0	0	0	0	0	0	0	0	0	0	0	0	0	0	0	0		
0	0	0	0	0	0	0	0	0	0	0	0	0	0	0	0	0	2057	2070	2066	2070	2066	2059	0	0	0	0	0	0	0	0	0	0	0	0	0	0	0	0	0		
0	0	0	0	0	0	0	0	0	0	0	0	0	0	0	0	2052	2056	2070	2070	2066	2066	2055	2054	0	0	0	0	0	0	0	0	0	0	0	0	0	0	0	0		
0	0	0	0	0	0	0	0	0	0	0	0	0	0	0	0	2057	2058	2066	2066	2066	2066	2058	2059	0	0	0	0	0	0	0	0	0	0	0	0	0	0	0	0		
0	0	0	0	0	0	0	0	0	0	0	0	0	0	0	0	2057	2071	2050	2063	2063	2051	2070	2059	0	0	0	0	0	0	0	0	0	0	0	0	0	0	0	0		
0	0	0	0	0	0	0	0	0	0	0	0	0	0	0	0	2062	2051	2055	2053	2053	2056	2050	2064	0	0	0	0	0	0	0	0	0	0	0	0	0	0	0	0		
0	0	0	17	17	18	0	0	0	0	0	0	0	0	0	0	0	2057	2066	2065	2061	2060	2059	0	0	0	0	0	0	0	0	0	0	0	0	0	0	0	0	0		
0	0	0	0	0	0	0	0	0	0	0	0	0	0	0	2052	2053	2056	2060	2061	2065	2066	2055	2053	2054	0	0	0	0	0	0	0	0	0	16	17	17	0	0	0		
0	0	0	0	0	0	0	0	0	0	0	0	0	0	0	0	0	0	0	0	0	0	0	0	0	0	0	0	0	0	0	0	0	0	0	0	0	0	0	0		
0	0	0	0	0	0	2178	2178	2178	2178	2178	0	0	0	0	0	0	0	0	0	0	0	0	0	0	0	0	0	0	2178	2178	2178	2178	2178	0	0	0	0	0	0		
0	0	0	0	0	0	0	0	0	0	0	0	0	0	0	0	0	0	0	0	0	0	0	0	0	0	0	0	0	0	0	0	0	0	0	0	0	0	0	0		
0	0	0	0	0	0	0	0	0	0	0	0	0	0	0	0	0	0	0	0	0	0	0	0	0	0	0	0	0	0	0	0	0	0	0	0	0	0	0	0		
))	))																																								
